Year,Month,Code,Import,Export,DIFF
2016,12,AF,1539,7282454,-7280915
2016,12,AL,83768,526938,-443170
2016,12,DZ,1179,14060570,-14059391
2016,12,AS,24691,43055,-18364
2016,12,AD,0,64243,-64243
2016,12,AO,11723,11722796,-11711073
2016,12,AI,0,340,-340
2016,12,AQ,0,1177,-1177
2016,12,AG,14,84744,-84730
2016,12,AR,82559747,9376036,73183711
2016,12,AM,5411,552258,-546847
2016,12,AU,362697706,624719780,-262022074
2016,12,AT,40464766,7685024,32779742
2016,12,AZ,4383,980219,-975836
2016,12,BS,15915,107480,-91565
2016,12,BH,35225999,4743645,30482354
2016,12,BD,13310382,81185253,-67874871
2016,12,BB,951,193845,-192894
2016,12,BY,4501636,184154,4317482
2016,12,BE,44942475,96217033,-51274558
2016,12,BZ,0,107393,-107393
2016,12,BJ,0,22425390,-22425390
2016,12,BM,0,82496,-82496
2016,12,BT,1029,128043,-127014
2016,12,BO,980315,969953,10362
2016,12,BA,353,20433,-20080
2016,12,BW,0,267808,-267808
2016,12,BR,207372453,69173840,138198613
2016,12,VG,0,3740838,-3740838
2016,12,BN,4001557,42847950,-38846393
2016,12,BG,2923834,5969641,-3045807
2016,12,BF,184846,214818,-29972
2016,12,KH,16469055,17148423,-679368
2016,12,CM,7775830,7541633,234197
2016,12,CA,59422863,55256422,4166441
2016,12,CV,0,62925,-62925
2016,12,CF,155865,229114,-73249
2016,12,CL,11241599,10513279,728320
2016,12,CX,0,9605,-9605
2016,12,CO,3925899,6466893,-2540994
2016,12,KM,0,480814,-480814
2016,12,CG,1061159,2273058,-1211899
2016,12,CD,12982499,1414041,11568458
2016,12,CK,0,12980,-12980
2016,12,CR,1639023,4256294,-2617271
2016,12,CI,34310273,5799820,28510453
2016,12,HR,393267,1660542,-1267275
2016,12,CU,161585,85452,76133
2016,12,CW,375,63067,-62692
2016,12,CY,686754,587131,99623
2016,12,CZ,14742199,27598956,-12856757
2016,12,KP,0,83718,-83718
2016,12,DK,13302733,13056047,246686
2016,12,DJ,0,7347059,-7347059
2016,12,DM,0,39105,-39105
2016,12,DO,562993,4048175,-3485182
2016,12,EC,6768434,1440565,5327869
2016,12,EG,18327230,56945898,-38618668
2016,12,SV,674,1312728,-1312054
2016,12,GQ,0,1303791,-1303791
2016,12,ER,0,497273,-497273
2016,12,EE,406341,3324432,-2918091
2016,12,ET,45594,12271685,-12226091
2016,12,FO,33767,0,33767
2016,12,FM,0,44343,-44343
2016,12,DE,450994156,482462969,-31468813
2016,12,FJ,32607,4869104,-4836497
2016,12,FI,11251308,9170343,2080965
2016,12,FR,132447009,110607862,21839147
2016,12,PF,0,454846,-454846
2016,12,GA,35125343,1885042,33240301
2016,12,GM,0,2668248,-2668248
2016,12,GE,164585,955201,-790616
2016,12,GH,17237508,20414610,-3177102
2016,12,GI,0,38990,-38990
2016,12,GR,2214232,6586931,-4372699
2016,12,GL,759,0,759
2016,12,GD,0,841191,-841191
2016,12,GP,0,99773,-99773
2016,12,GU,481,167429,-166948
2016,12,GT,283202,2376871,-2093669
2016,12,GN,88211,1249031,-1160820
2016,12,GW,0,168689,-168689
2016,12,GY,46652,558866,-512214
2016,12,HT,0,480839,-480839
2016,12,HN,16542,1238636,-1222094
2016,12,HK,264052854,808721175,-544668321
2016,12,HU,12541747,30574708,-18032961
2016,12,IS,2016,132393,-130377
2016,12,IN,382638289,620386005,-237747716
2016,12,IQ,39676045,15966992,23709053
2016,12,IE,60567929,13509021,47058908
2016,12,IR,3865769,43648348,-39782579
2016,12,IT,124817148,68059109,56758039
2016,12,JM,24176,1914584,-1890408
2016,12,JP,1170275611,1358012252,-187736641
2016,12,JO,2772065,7781728,-5009663
2016,12,KZ,490797,3955208,-3464411
2016,12,KE,1430416,10398046,-8967630
2016,12,KI,304267,141657,162610
2016,12,KW,8415868,14511545,-6095677
2016,12,KG,0,295108,-295108
2016,12,LV,685546,14116689,-13431143
2016,12,LB,1271791,4677435,-3405644
2016,12,LS,0,69285,-69285
2016,12,LR,198918,990673,-791755
2016,12,LY,147183,1053114,-905931
2016,12,LI,6175,43478,-37303
2016,12,LT,35114103,1678750,33435353
2016,12,LU,2010134,981844,1028290
2016,12,MO,927300,2305047,-1377747
2016,12,MK,58911,10681,48230
2016,12,MG,514227,5957276,-5443049
2016,12,MW,308213,5328492,-5020279
2016,12,MY,1440863,0,1440863
2016,12,MV,619723,14930958,-14311235
2016,12,ML,0,524368,-524368
2016,12,MT,1574212,1773867,-199655
2016,12,MH,0,71812,-71812
2016,12,MQ,0,63156,-63156
2016,12,MR,0,5410650,-5410650
2016,12,MU,149120,7495101,-7345981
2016,12,YT,0,293291,-293291
2016,12,MX,46104643,178953791,-132849148
2016,12,MC,108,0,108
2016,12,ME,0,82259,-82259
2016,12,MA,2794990,6881264,-4086274
2016,12,MZ,2197070,10380046,-8182976
2016,12,NA,116975,300347,-183372
2016,12,NR,0,77307,-77307
2016,12,NP,81597,2231892,-2150295
2016,12,NL,251131871,476283987,-225152116
2016,12,NC,0,1493785,-1493785
2016,12,NZ,72257739,52354352,19903387
2016,12,NI,77649,105785,-28136
2016,12,NE,0,126804,-126804
2016,12,NG,13851771,12054166,1797605
2016,12,MP,0,152649,-152649
2016,12,NO,20679796,6484216,14195580
2016,12,OM,26392990,19570980,6822010
2016,12,ZZ,1348247,2698184,-1349937
2016,12,PK,16073925,118324076,-102250151
2016,12,PS,0,87351,-87351
2016,12,PA,3444959,9350048,-5905089
2016,12,PG,19848736,18559190,1289546
2016,12,PY,0,600850,-600850
2016,12,LA,407778,1449800,-1042022
2016,12,MN,227838,1103537,-875699
2016,12,CN,3229613684,2290825039,938788645
2016,12,PE,14413075,7349186,7063889
2016,12,PH,156458628,268492898,-112034270
2016,12,PL,18930837,24279431,-5348594
2016,12,PT,4675359,6174910,-1499551
2016,12,PR,25121,1020455,-995334
2016,12,QA,61926808,13149757,48777051
2016,12,ID,676744127,606793456,69950671
2016,12,KR,656818500,604652084,52166416
2016,12,MD,869343,61612,807731
2016,12,SG,1376037879,2452499982,-1076462103
2016,12,ZA,25261053,50527983,-25266930
2016,12,LK,6290943,82175870,-75884927
2016,12,YE,1059735,18236489,-17176754
2016,12,RE,16970,1361794,-1344824
2016,12,RO,2351855,6619859,-4268004
2016,12,RU,36820914,49966367,-13145453
2016,12,RW,2094047,213650,1880397
2016,12,LC,0,181060,-181060
2016,12,VC,0,13151,-13151
2016,12,SA,286006328,81056904,204949424
2016,12,SN,16232,6312979,-6296747
2016,12,RS,126162,722600,-596438
2016,12,SC,705207,9767468,-9062261
2016,12,SL,0,1967865,-1967865
2016,12,SK,2180540,3576233,-1395693
2016,12,SI,1333865,13351207,-12017342
2016,12,VN,469874903,481624435,-11749532
2016,12,SB,832453,1888662,-1056209
2016,12,SO,0,10155178,-10155178
2016,12,ES,50278010,50100056,177954
2016,12,SD,54548,7332590,-7278042
2016,12,SR,33690,354175,-320485
2016,12,SW,174829,0,174829
2016,12,SZ,0,139578,-139578
2016,12,SE,42101625,35309243,6792382
2016,12,CH,203203528,96090105,107113423
2016,12,SY,115424,3434929,-3319505
2016,12,TW,895242239,475856654,419385585
2016,12,TJ,0,280869,-280869
2016,12,TH,891116697,942622037,-51505340
2016,12,TL,28180,843306,-815126
2016,12,TG,0,10166009,-10166009
2016,12,TO,0,230259,-230259
2016,12,TT,10243,1791099,-1780856
2016,12,TN,298929,3765537,-3466608
2016,12,TR,27046849,224457622,-197410773
2016,12,TM,10046,799261,-789215
2016,12,TV,0,10872,-10872
2016,12,UG,2250494,362886,1887608
2016,12,UA,7045436,6393718,651718
2016,12,MM,16451632,85815630,-69363998
2016,12,AE,242884358,271951213,-29066855
2016,12,GB,136487520,169513157,-33025637
2016,12,TZ,3550002,8936966,-5386964
2016,12,US,1157759666,1608469709,-450710043
2016,12,UY,867593,2063973,-1196380
2016,12,UZ,360,4375202,-4374842
2016,12,VU,307618,324606,-16988
2016,12,VE,22124814,470352,21654462
2016,12,WS,0,319444,-319444
2016,12,ZM,862212,271947,590265
2016,12,ZW,143476,619407,-475931
2016,11,AF,63188,11206504,-11143316
2016,11,AL,16635,7465288,-7448653
2016,11,DZ,22017,9029081,-9007064
2016,11,AS,0,63369,-63369
2016,11,AO,551,13727403,-13726852
2016,11,AI,0,366,-366
2016,11,AG,0,25916,-25916
2016,11,AR,106425301,10401079,96024222
2016,11,AM,1595,517302,-515707
2016,11,AW,0,131247,-131247
2016,11,AU,299973993,624795028,-324821035
2016,11,AT,41875453,9309668,32565785
2016,11,AZ,0,583723,-583723
2016,11,BS,5073,875019,-869946
2016,11,BH,988595,5346749,-4358154
2016,11,BD,18953579,108102860,-89149281
2016,11,BB,3556,179906,-176350
2016,11,BY,3777985,221446,3556539
2016,11,BE,43698284,89945608,-46247324
2016,11,BZ,1249,189438,-188189
2016,11,BJ,2919,34046355,-34043436
2016,11,BM,0,2484,-2484
2016,11,BT,0,70814,-70814
2016,11,BO,996271,469535,526736
2016,11,BA,149719,26612,123107
2016,11,BW,0,75970,-75970
2016,11,BR,276156934,52909243,223247691
2016,11,VG,14670,61946,-47276
2016,11,BN,3475137,41739365,-38264228
2016,11,BG,2482464,4826400,-2343936
2016,11,BF,183195,310940,-127745
2016,11,BI,0,26384,-26384
2016,11,KH,16855861,18916578,-2060717
2016,11,CM,10126590,5702145,4424445
2016,11,CA,53732389,58341178,-4608789
2016,11,CV,0,123181,-123181
2016,11,KY,0,24172,-24172
2016,11,CF,0,36042,-36042
2016,11,CL,25801162,14012194,11788968
2016,11,CX,1508794,0,1508794
2016,11,CO,2215792,6396164,-4180372
2016,11,KM,160900,780047,-619147
2016,11,CG,2072290,2344064,-271774
2016,11,CD,4159424,5265790,-1106366
2016,11,CK,0,16354,-16354
2016,11,CR,1623431,5986225,-4362794
2016,11,CI,22074320,6585375,15488945
2016,11,HR,633217,1667194,-1033977
2016,11,CU,62001,529075,-467074
2016,11,CW,0,51409,-51409
2016,11,CY,494320,4077708,-3583388
2016,11,CZ,17185803,26553217,-9367414
2016,11,KP,0,99230,-99230
2016,11,DK,13881449,10584955,3296494
2016,11,DJ,0,8888527,-8888527
2016,11,DM,0,35129,-35129
2016,11,DO,668471,2139543,-1471072
2016,11,EC,5671344,1331725,4339619
2016,11,EG,4645357,35454734,-30809377
2016,11,SV,38004,1098599,-1060595
2016,11,GQ,0,610178,-610178
2016,11,ER,0,140415,-140415
2016,11,EE,353370,3110682,-2757312
2016,11,ET,229110,12241159,-12012049
2016,11,FM,0,46899,-46899
2016,11,DE,481907979,465167896,16740083
2016,11,FJ,350311,3000562,-2650251
2016,11,FI,11990838,7275874,4714964
2016,11,FR,183344512,107327834,76016678
2016,11,GF,0,31397,-31397
2016,11,PF,0,159390,-159390
2016,11,GA,86141,3910258,-3824117
2016,11,GM,0,1909662,-1909662
2016,11,GE,12207,1552917,-1540710
2016,11,GH,5392853,17815416,-12422563
2016,11,GI,0,16651,-16651
2016,11,GR,3693780,4015144,-321364
2016,11,GL,36953,0,36953
2016,11,GD,0,329949,-329949
2016,11,GP,0,145770,-145770
2016,11,GU,754,378107,-377353
2016,11,GT,278450,1728155,-1449705
2016,11,GN,40365,11367537,-11327172
2016,11,GW,0,612153,-612153
2016,11,GY,38869,657566,-618697
2016,11,HT,0,1337170,-1337170
2016,11,HN,576972,1342991,-766019
2016,11,HK,303789812,745520327,-441730515
2016,11,HU,9514444,25887896,-16373452
2016,11,IS,101880,26249,75631
2016,11,IN,334241092,679758853,-345517761
2016,11,IQ,24469441,15867191,8602250
2016,11,IE,52966903,12167878,40799025
2016,11,IR,20862455,47958714,-27096259
2016,11,IT,131673307,57858778,73814529
2016,11,JM,10109,2140749,-2130640
2016,11,JP,1191762861,1411437243,-219674382
2016,11,JO,3437152,7403364,-3966212
2016,11,KZ,1245476,3464935,-2219459
2016,11,KE,1114545,22447647,-21333102
2016,11,KI,154563,71541,83022
2016,11,KW,73773240,15073473,58699767
2016,11,KG,8706,102770,-94064
2016,11,LV,3132212,4099509,-967297
2016,11,LB,750546,5646657,-4896111
2016,11,LS,0,128274,-128274
2016,11,LR,1021804,1564798,-542994
2016,11,LY,878,810947,-810069
2016,11,LI,306961,18026,288935
2016,11,LT,1647927,2028705,-380778
2016,11,LU,1710327,1396351,313976
2016,11,MO,977584,2424099,-1446515
2016,11,MK,18254,151587,-133333
2016,11,MG,462356,6863045,-6400689
2016,11,MW,109214,78661,30553
2016,11,MY,393483,0,393483
2016,11,MV,9184,8780831,-8771647
2016,11,ML,0,234563,-234563
2016,11,MT,9983055,2040668,7942387
2016,11,MH,174376,50955,123421
2016,11,MQ,0,165971,-165971
2016,11,MR,0,6891730,-6891730
2016,11,MU,221663,8042478,-7820815
2016,11,YT,0,362493,-362493
2016,11,MX,28893624,151488349,-122594725
2016,11,MC,99,4320,-4221
2016,11,ME,0,65399,-65399
2016,11,MA,1193443,2812742,-1619299
2016,11,MZ,180525,35858871,-35678346
2016,11,NA,47900,132248,-84348
2016,11,NP,24447,1876949,-1852502
2016,11,NL,117787502,521075943,-403288441
2016,11,NC,0,1265884,-1265884
2016,11,NZ,83723919,92781339,-9057420
2016,11,NI,52026,379951,-327925
2016,11,NE,0,749985,-749985
2016,11,NG,19614319,40417152,-20802833
2016,11,MP,0,41216,-41216
2016,11,NO,26693009,7749198,18943811
2016,11,OM,24719871,18063767,6656104
2016,11,ZZ,13804293,1160346,12643947
2016,11,PK,14134474,96753231,-82618757
2016,11,PW,0,74214,-74214
2016,11,PS,40282,19267,21015
2016,11,PA,4279432,10110263,-5830831
2016,11,PG,31300072,22373087,8926985
2016,11,PY,40508,855246,-814738
2016,11,LA,465576,1472892,-1007316
2016,11,MN,1577,1486457,-1484880
2016,11,CN,3158175180,2523575921,634599259
2016,11,PE,14877985,8497953,6380032
2016,11,PH,117169398,244224246,-127054848
2016,11,PL,13608572,22962168,-9353596
2016,11,PT,4926192,5038830,-112638
2016,11,PR,1979412,1499409,480003
2016,11,QA,43933541,11304694,32628847
2016,11,ID,634498486,579498660,54999826
2016,11,KR,689224192,421720433,267503759
2016,11,MD,1336976,24182,1312794
2016,11,SG,1445104222,2413097382,-967993160
2016,11,ZA,45386938,54810272,-9423334
2016,11,LK,5126452,44057287,-38930835
2016,11,YE,739599,17968001,-17228402
2016,11,RE,0,1128252,-1128252
2016,11,RO,8981181,9257100,-275919
2016,11,RU,118548299,38336185,80212114
2016,11,RW,1362705,1121949,240756
2016,11,LC,0,1852,-1852
2016,11,VC,0,82742,-82742
2016,11,ST,0,59841,-59841
2016,11,SA,199817110,73415322,126401788
2016,11,SN,0,4545419,-4545419
2016,11,RS,272491,478262,-205771
2016,11,SC,237808,526555,-288747
2016,11,SL,114467,1049084,-934617
2016,11,SK,2419271,6756868,-4337597
2016,11,SI,2130386,18270346,-16139960
2016,11,VN,425226001,528291994,-103065993
2016,11,SB,1265875,4231046,-2965171
2016,11,SO,0,9456913,-9456913
2016,11,ES,45842534,47017420,-1174886
2016,11,SD,19755,6316575,-6296820
2016,11,SR,8644,306027,-297383
2016,11,SW,25045,0,25045
2016,11,SZ,0,766130,-766130
2016,11,SE,36028418,24666041,11362377
2016,11,CH,156942077,71745624,85196453
2016,11,SY,18362,3702687,-3684325
2016,11,TW,905058923,448076983,456981940
2016,11,TJ,0,87424,-87424
2016,11,TH,888867013,893954553,-5087540
2016,11,TL,4800,713731,-708931
2016,11,TG,4259,28130833,-28126574
2016,11,TK,14223,0,14223
2016,11,TO,0,166808,-166808
2016,11,TT,88077,1554321,-1466244
2016,11,TN,541487,3298749,-2757262
2016,11,TR,25458441,156296506,-130838065
2016,11,TM,4654,1624169,-1619515
2016,11,TV,0,53145,-53145
2016,11,UG,637819,666759,-28940
2016,11,UA,7612649,5286728,2325921
2016,11,MM,17278637,99123494,-81844857
2016,11,AE,241311673,242091422,-779749
2016,11,GB,119791089,177921048,-58129959
2016,11,TZ,7873830,25088589,-17214759
2016,11,US,1106566435,1537684345,-431117910
2016,11,VI,0,1385,-1385
2016,11,UY,3663044,2588135,1074909
2016,11,UZ,927,8855360,-8854433
2016,11,VU,649423,136611,512812
2016,11,VE,22001448,377140,21624308
2016,11,WS,0,450056,-450056
2016,11,ZM,263,299300,-299037
2016,11,ZW,0,1054314,-1054314
2016,10,AF,65331,12200765,-12135434
2016,10,AL,9488,205456,-195968
2016,10,DZ,131,7110110,-7109979
2016,10,AS,130645,6917654,-6787009
2016,10,AO,7687,15464287,-15456600
2016,10,AG,1317,63446,-62129
2016,10,AR,90625427,9505127,81120300
2016,10,AM,14013,401080,-387067
2016,10,AW,0,2640,-2640
2016,10,AU,387898790,509457983,-121559193
2016,10,AT,45165626,9252119,35913507
2016,10,AZ,8360,663182,-654822
2016,10,BS,97841,530354,-432513
2016,10,BH,823580,4727863,-3904283
2016,10,BD,11506613,110885604,-99378991
2016,10,BB,5588,129302,-123714
2016,10,BY,2318610,325561,1993049
2016,10,BE,52080222,93317896,-41237674
2016,10,BZ,0,174389,-174389
2016,10,BJ,3757,32079795,-32076038
2016,10,BM,0,85183,-85183
2016,10,BT,878,238145,-237267
2016,10,BO,420972,629173,-208201
2016,10,BA,62009,30863,31146
2016,10,BW,0,196214,-196214
2016,10,BR,123689193,61235883,62453310
2016,10,VG,38313,0,38313
2016,10,BN,26529846,37283795,-10753949
2016,10,BG,3122804,6743855,-3621051
2016,10,BF,374867,121095,253772
2016,10,KH,9374753,24504703,-15129950
2016,10,CM,1924694,2111880,-187186
2016,10,CA,39916368,56499706,-16583338
2016,10,CV,0,367519,-367519
2016,10,KY,0,910,-910
2016,10,CF,0,1803707,-1803707
2016,10,TD,0,1003,-1003
2016,10,CL,13200835,13173643,27192
2016,10,CX,3609268,128401,3480867
2016,10,CO,1961069,7598095,-5637026
2016,10,KM,0,158025,-158025
2016,10,CG,5034870,3248769,1786101
2016,10,CD,936876,777883,158993
2016,10,CK,0,12185,-12185
2016,10,CR,2167071,2532116,-365045
2016,10,CI,22073242,7621651,14451591
2016,10,HR,158330,1132128,-973798
2016,10,CU,160728,370009,-209281
2016,10,CW,0,36284,-36284
2016,10,CY,565835,613178,-47343
2016,10,CZ,23289854,32368194,-9078340
2016,10,KP,0,5836,-5836
2016,10,DK,16754394,12391024,4363370
2016,10,DJ,0,6987330,-6987330
2016,10,DM,0,13733,-13733
2016,10,DO,253005,3374533,-3121528
2016,10,EC,4134162,2037407,2096755
2016,10,EG,4116864,39479546,-35362682
2016,10,SV,3364,1669959,-1666595
2016,10,GQ,0,1286785,-1286785
2016,10,ER,0,622643,-622643
2016,10,EE,344456,2292430,-1947974
2016,10,ET,186519,7880262,-7693743
2016,10,FM,0,7534,-7534
2016,10,DE,532011251,492749702,39261549
2016,10,FJ,1367078,6398398,-5031320
2016,10,FI,14906340,8888886,6017454
2016,10,FR,212099056,108732520,103366536
2016,10,GF,0,117606,-117606
2016,10,PF,0,8217608,-8217608
2016,10,GA,1042,2250915,-2249873
2016,10,GM,0,1894966,-1894966
2016,10,GE,113301,1593276,-1479975
2016,10,GH,3823683,26708734,-22885051
2016,10,GI,0,1596,-1596
2016,10,GR,1384578,6016303,-4631725
2016,10,GL,13594,0,13594
2016,10,GD,0,350793,-350793
2016,10,GP,0,169942,-169942
2016,10,GU,0,286618,-286618
2016,10,GT,330311,5036328,-4706017
2016,10,GN,28757,4746717,-4717960
2016,10,GW,0,314062,-314062
2016,10,GY,67183,454243,-387060
2016,10,HT,44242,1663402,-1619160
2016,10,HN,141461,869908,-728447
2016,10,HK,253184729,796052568,-542867839
2016,10,HU,11592732,21517865,-9925133
2016,10,IS,953,105340,-104387
2016,10,IN,337643614,657384809,-319741195
2016,10,IQ,7227477,11750957,-4523480
2016,10,IE,81631481,10400642,71230839
2016,10,IR,23117559,34179226,-11061667
2016,10,IT,93613360,73696686,19916674
2016,10,JM,62148,1755075,-1692927
2016,10,JP,1160752833,1179542226,-18789393
2016,10,JO,5661880,8609536,-2947656
2016,10,KZ,607967,2767669,-2159702
2016,10,KE,717570,10893742,-10176172
2016,10,KI,514330,13268,501062
2016,10,KW,53082292,13489622,39592670
2016,10,KG,0,279983,-279983
2016,10,LV,726438,12739005,-12012567
2016,10,LB,278539,6041985,-5763446
2016,10,LR,536560,2008462,-1471902
2016,10,LY,247,829595,-829348
2016,10,LI,19233,16131,3102
2016,10,LT,3059447,2221413,838034
2016,10,LU,1952323,761462,1190861
2016,10,MO,918569,2457311,-1538742
2016,10,MK,87395,277,87118
2016,10,MG,234305,5046647,-4812342
2016,10,MW,211929,6123843,-5911914
2016,10,MY,2174089,0,2174089
2016,10,MV,2142,10236021,-10233879
2016,10,ML,0,53621,-53621
2016,10,MT,2063862,1893836,170026
2016,10,MH,428398,168244,260154
2016,10,MQ,0,84094,-84094
2016,10,MR,0,3572754,-3572754
2016,10,MU,474336,9169654,-8695318
2016,10,YT,0,504810,-504810
2016,10,MX,31614006,169069882,-137455876
2016,10,MC,4721,23401,-18680
2016,10,ME,0,42691,-42691
2016,10,MA,2385456,5637467,-3252011
2016,10,MZ,1810455,2187249,-376794
2016,10,NA,24685,264015,-239330
2016,10,NR,0,65546,-65546
2016,10,NP,31178,2720477,-2689299
2016,10,NL,115119278,513030074,-397910796
2016,10,NC,0,2792079,-2792079
2016,10,NZ,48038128,118969858,-70931730
2016,10,NI,4226,790104,-785878
2016,10,NE,225154,5887,219267
2016,10,NG,7622420,49351364,-41728944
2016,10,MP,303,100662,-100359
2016,10,NO,13320666,3844016,9476650
2016,10,OM,24864974,15555902,9309072
2016,10,ZZ,23403837,1074324,22329513
2016,10,PK,10218772,112471668,-102252896
2016,10,PW,0,5225,-5225
2016,10,PS,7663,76443,-68780
2016,10,PA,72195,9379018,-9306823
2016,10,PG,10067792,30678790,-20610998
2016,10,PY,0,444309,-444309
2016,10,LA,362801,1146419,-783618
2016,10,MN,393,1885181,-1884788
2016,10,CN,2766713418,2275180139,491533279
2016,10,PE,3322832,9177662,-5854830
2016,10,PH,148622556,291001266,-142378710
2016,10,PL,9951440,24777994,-14826554
2016,10,PT,3794850,5310306,-1515456
2016,10,PR,923527,1500123,-576596
2016,10,QA,77266798,14062246,63204552
2016,10,ID,671369545,636659157,34710388
2016,10,KR,839705107,517931293,321773814
2016,10,MD,2101006,524,2100482
2016,10,SG,1596099550,2323560095,-727460545
2016,10,ZA,35093590,63236024,-28142434
2016,10,LK,4876189,57425821,-52549632
2016,10,YE,144225,12915188,-12770963
2016,10,RE,0,1585404,-1585404
2016,10,RO,8882531,7965447,917084
2016,10,RU,66301531,53961435,12340096
2016,10,RW,569060,49887,519173
2016,10,GS,0,37787,-37787
2016,10,VC,0,84886,-84886
2016,10,SA,197849747,66353346,131496401
2016,10,SN,1284,5992960,-5991676
2016,10,RS,76337,732429,-656092
2016,10,SC,0,1337330,-1337330
2016,10,SL,0,1034527,-1034527
2016,10,SK,2112626,6764785,-4652159
2016,10,SI,2744089,22524713,-19780624
2016,10,VN,378541928,481681092,-103139164
2016,10,SB,1197745,4911078,-3713333
2016,10,SO,0,8483846,-8483846
2016,10,ES,49010102,36941362,12068740
2016,10,SD,236133,2895636,-2659503
2016,10,SR,642,265570,-264928
2016,10,SW,25988,0,25988
2016,10,SZ,15965,0,15965
2016,10,SE,36677532,30533633,6143899
2016,10,CH,212692231,75480194,137212037
2016,10,SY,17591,3434343,-3416752
2016,10,TW,846794453,446005391,400789062
2016,10,TJ,0,184292,-184292
2016,10,TH,833806711,897003046,-63196335
2016,10,TL,19946,714839,-694893
2016,10,TG,1059790,2417189,-1357399
2016,10,TO,0,75254,-75254
2016,10,TT,1230,1588444,-1587214
2016,10,TN,434202,2887319,-2453117
2016,10,TR,21659980,174681668,-153021688
2016,10,TM,0,623306,-623306
2016,10,TC,0,14005,-14005
2016,10,TV,0,216403,-216403
2016,10,UG,137882,879662,-741780
2016,10,UA,7091779,5941502,1150277
2016,10,MM,13795297,94711900,-80916603
2016,10,AE,198984254,244455547,-45471293
2016,10,GB,117653204,181531965,-63878761
2016,10,TZ,15975707,16863551,-887844
2016,10,US,1039362937,1685986831,-646623894
2016,10,VI,0,161630,-161630
2016,10,UY,458232,1739771,-1281539
2016,10,UZ,1212,18025574,-18024362
2016,10,VU,747978,13790226,-13042248
2016,10,VE,21977633,814228,21163405
2016,10,WS,0,430220,-430220
2016,10,ZM,537,109272,-108735
2016,10,ZW,969956,492704,477252
2016,9,AF,180,6301714,-6301534
2016,9,AL,125469,386576,-261107
2016,9,DZ,91430,9207696,-9116266
2016,9,AS,180572,200572,-20000
2016,9,AO,23559,14236229,-14212670
2016,9,AG,0,38470,-38470
2016,9,AR,107460428,30757473,76702955
2016,9,AM,15573,20598,-5025
2016,9,AW,0,15971,-15971
2016,9,AU,394086076,500707629,-106621553
2016,9,AT,40238354,8023374,32214980
2016,9,AZ,1715,664340,-662625
2016,9,BS,6235011,479298,5755713
2016,9,BH,9777242,4645118,5132124
2016,9,BD,13031846,103186389,-90154543
2016,9,BB,4294,166215,-161921
2016,9,BY,2576097,257129,2318968
2016,9,BE,49951615,87476583,-37524968
2016,9,BZ,232493,442646,-210153
2016,9,BJ,0,19043165,-19043165
2016,9,BM,1676,4583,-2907
2016,9,BT,0,40573,-40573
2016,9,BO,360655,756479,-395824
2016,9,BA,0,82709,-82709
2016,9,BW,5869,243229,-237360
2016,9,BR,147119169,66147498,80971671
2016,9,VG,26928,3768384,-3741456
2016,9,BN,3046641,43790256,-40743615
2016,9,BG,3261634,4554578,-1292944
2016,9,BF,926583,221058,705525
2016,9,KH,12208862,23112147,-10903285
2016,9,CM,9092041,5487977,3604064
2016,9,CA,37586916,61756585,-24169669
2016,9,CV,0,79324,-79324
2016,9,KY,0,1026,-1026
2016,9,CF,0,14091,-14091
2016,9,CL,4295209,15196014,-10900805
2016,9,CX,675561,9171,666390
2016,9,CO,976901,9001426,-8024525
2016,9,KM,0,160887,-160887
2016,9,CG,7322392,2799174,4523218
2016,9,CD,3233838,824403,2409435
2016,9,CK,0,24399,-24399
2016,9,CR,1436327,2414886,-978559
2016,9,CI,21079307,4085217,16994090
2016,9,HR,9542275,1122601,8419674
2016,9,CU,256314,892337,-636023
2016,9,CW,0,108869,-108869
2016,9,CY,470370,1012837,-542467
2016,9,CZ,14762826,27463947,-12701121
2016,9,KP,37514,14218,23296
2016,9,DK,15968448,9643997,6324451
2016,9,DJ,42315,8531953,-8489638
2016,9,DM,0,15410,-15410
2016,9,DO,680457,2862587,-2182130
2016,9,EC,4190706,1436872,2753834
2016,9,EG,4663352,43861899,-39198547
2016,9,SV,154371,1878718,-1724347
2016,9,GQ,0,664323,-664323
2016,9,ER,0,1530135,-1530135
2016,9,EE,947010,3104826,-2157816
2016,9,ET,171896,9018780,-8846884
2016,9,FM,0,10194,-10194
2016,9,DE,434578175,458931313,-24353138
2016,9,FJ,930296,4741009,-3810713
2016,9,FI,8744575,7236535,1508040
2016,9,FR,280991971,128147727,152844244
2016,9,GF,0,111514,-111514
2016,9,PF,0,455218,-455218
2016,9,GA,28489,1539264,-1510775
2016,9,GM,0,3138784,-3138784
2016,9,GE,302032,808073,-506041
2016,9,GH,5625291,10581400,-4956109
2016,9,GI,0,15030,-15030
2016,9,GR,926220,5946200,-5019980
2016,9,GL,11415,0,11415
2016,9,GD,4919,730875,-725956
2016,9,GP,0,114039,-114039
2016,9,GU,447,253415,-252968
2016,9,GT,1443082,1896738,-453656
2016,9,GN,90749,3211268,-3120519
2016,9,GW,0,903117,-903117
2016,9,GY,8417,345026,-336609
2016,9,HT,0,886521,-886521
2016,9,HN,68009,951621,-883612
2016,9,HK,258083849,790599438,-532515589
2016,9,HU,12287669,23730047,-11442378
2016,9,IS,300,136427,-136127
2016,9,IN,519417206,685141120,-165723914
2016,9,IQ,11670161,7572660,4097501
2016,9,IE,49661735,8974500,40687235
2016,9,IR,73107344,58991477,14115867
2016,9,IT,106450170,84589333,21860837
2016,9,JM,6456,2196805,-2190349
2016,9,JP,1169840371,1328609643,-158769272
2016,9,JO,9682081,6517052,3165029
2016,9,KZ,42802,2717548,-2674746
2016,9,KE,2572233,8914663,-6342430
2016,9,KI,465178,203564,261614
2016,9,KW,44731794,10143898,34587896
2016,9,KG,0,192617,-192617
2016,9,LV,614222,3115348,-2501126
2016,9,LB,817084,4687423,-3870339
2016,9,LR,2464526,844516,1620010
2016,9,LY,358,711843,-711485
2016,9,LI,309984,66843,243141
2016,9,LT,1916531,3440693,-1524162
2016,9,LU,4360229,730241,3629988
2016,9,MO,1160099,2481029,-1320930
2016,9,MK,140233,17113,123120
2016,9,MG,331268,8069301,-7738033
2016,9,MW,570066,3304030,-2733964
2016,9,MY,1917337,0,1917337
2016,9,MV,31026,8174843,-8143817
2016,9,ML,500295,26713,473582
2016,9,MT,2441045,1947362,493683
2016,9,MH,599864,87654,512210
2016,9,MQ,0,56365,-56365
2016,9,MR,1470795,3317832,-1847037
2016,9,MU,484385,7284795,-6800410
2016,9,YT,0,104763,-104763
2016,9,MX,32665887,148426212,-115760325
2016,9,MC,0,76069,-76069
2016,9,ME,15521,31446,-15925
2016,9,MA,2684285,7867031,-5182746
2016,9,MZ,70134,17651181,-17581047
2016,9,NA,202926,634898,-431972
2016,9,NP,45214,1572356,-1527142
2016,9,NL,155814132,465155554,-309341422
2016,9,NC,0,973446,-973446
2016,9,NZ,39586915,48576558,-8989643
2016,9,NI,18602,498093,-479491
2016,9,NE,0,8163,-8163
2016,9,NG,6739129,27099103,-20359974
2016,9,MP,0,112968,-112968
2016,9,NO,24414990,11611833,12803157
2016,9,OM,19331457,20873942,-1542485
2016,9,ZZ,160931994,1555504,159376490
2016,9,PK,10118496,84856643,-74738147
2016,9,PW,0,42286,-42286
2016,9,PS,533,0,533
2016,9,PA,364346,11015413,-10651067
2016,9,PG,12893755,22566013,-9672258
2016,9,PY,6771,300895,-294124
2016,9,LA,3794147,1675400,2118747
2016,9,MN,0,1207353,-1207353
2016,9,CN,2999143402,2182442511,816700891
2016,9,PE,4176002,30787587,-26611585
2016,9,PH,134493999,300689343,-166195344
2016,9,PL,15035127,26217014,-11181887
2016,9,PT,4330150,5820319,-1490169
2016,9,PR,617465,3091037,-2473572
2016,9,QA,30747714,13760662,16987052
2016,9,ID,621608868,549902350,71706518
2016,9,KR,668017283,423055205,244962078
2016,9,MD,2147485,78521,2068964
2016,9,SG,1529666433,2533374249,-1003707816
2016,9,ZA,31441768,82597593,-51155825
2016,9,LK,3999578,37464128,-33464550
2016,9,YE,1018961,9087673,-8068712
2016,9,RE,37700,2079826,-2042126
2016,9,RO,2105121,7202396,-5097275
2016,9,RU,98675167,58126575,40548592
2016,9,RW,1594399,238705,1355694
2016,9,KN,0,829,-829
2016,9,VC,0,59411,-59411
2016,9,SA,276758474,66895201,209863273
2016,9,SN,0,4679143,-4679143
2016,9,RS,35916,277443,-241527
2016,9,SC,0,850271,-850271
2016,9,SL,0,696181,-696181
2016,9,SK,2256145,6780224,-4524079
2016,9,SI,2024837,24829570,-22804733
2016,9,VN,438268932,497291271,-59022339
2016,9,SB,3108475,2018819,1089656
2016,9,SO,0,4369005,-4369005
2016,9,ES,46907862,45931154,976708
2016,9,SD,7634,2839828,-2832194
2016,9,SR,3062,243712,-240650
2016,9,SJ,0,18016,-18016
2016,9,SW,214492,0,214492
2016,9,SZ,49443,65102,-15659
2016,9,SE,41683901,27852926,13830975
2016,9,CH,150639398,68837988,81801410
2016,9,SY,2027,2406105,-2404078
2016,9,TW,927856526,553651415,374205111
2016,9,TJ,0,93543,-93543
2016,9,TH,872254298,879988788,-7734490
2016,9,TL,4499,702943,-698444
2016,9,TG,77262,2037110,-1959848
2016,9,TO,0,92484,-92484
2016,9,TT,11006,2054647,-2043641
2016,9,TN,855920,4928853,-4072933
2016,9,TR,18972095,169251998,-150279903
2016,9,TM,0,4702663,-4702663
2016,9,TV,0,240214,-240214
2016,9,UM,0,64433,-64433
2016,9,UG,632713,972723,-340010
2016,9,UA,7184491,7923820,-739329
2016,9,MM,13241751,70150786,-56909035
2016,9,AE,134421536,230009528,-95587992
2016,9,GB,119191329,195275640,-76084311
2016,9,TZ,26835125,33097262,-6262137
2016,9,US,1047185869,1687282513,-640096644
2016,9,UY,2429522,2533516,-103994
2016,9,UZ,223966,5704958,-5480992
2016,9,VU,1262683,265476,997207
2016,9,VA,0,45185,-45185
2016,9,VE,23239931,546061,22693870
2016,9,WF,0,6065,-6065
2016,9,WS,0,518504,-518504
2016,9,ZM,261577,274152,-12575
2016,9,ZW,121636,2163417,-2041781
2016,8,AF,4567,6530680,-6526113
2016,8,AL,78112,164572,-86460
2016,8,DZ,51136,8715326,-8664190
2016,8,AS,0,147895,-147895
2016,8,AO,223959,12198696,-11974737
2016,8,AG,1027,170428,-169401
2016,8,AR,114360502,15944530,98415972
2016,8,AM,2393,43158,-40765
2016,8,AW,0,159482,-159482
2016,8,AU,288666682,484802409,-196135727
2016,8,AT,39886864,9157175,30729689
2016,8,AZ,141737,528979,-387242
2016,8,BS,4320,782900,-778580
2016,8,BH,28440613,5285029,23155584
2016,8,BD,15644905,100416784,-84771879
2016,8,BB,4974,109813,-104839
2016,8,BY,2944370,105687,2838683
2016,8,BE,51207530,90962152,-39754622
2016,8,BZ,0,173604,-173604
2016,8,BJ,0,18431794,-18431794
2016,8,BM,0,5662,-5662
2016,8,BT,0,55420,-55420
2016,8,BO,765868,972901,-207033
2016,8,BA,721,74650,-73929
2016,8,BW,0,256238,-256238
2016,8,BR,233350118,51651067,181699051
2016,8,VG,30269,0,30269
2016,8,BN,27500807,45974381,-18473574
2016,8,BG,2808594,5525175,-2716581
2016,8,BF,1243363,263824,979539
2016,8,KH,11806981,21154656,-9347675
2016,8,CM,1982152,6486389,-4504237
2016,8,CA,68937147,69654530,-717383
2016,8,KY,0,3327,-3327
2016,8,CF,0,259027,-259027
2016,8,TD,0,6687,-6687
2016,8,CL,4201916,13820213,-9618297
2016,8,CX,1501746,8189,1493557
2016,8,CO,3577048,15206949,-11629901
2016,8,KM,0,936471,-936471
2016,8,CG,7075673,5569705,1505968
2016,8,CD,2217278,2316525,-99247
2016,8,CK,0,7790,-7790
2016,8,CR,1785815,3231402,-1445587
2016,8,CI,20049596,5533513,14516083
2016,8,HR,4966585,1489613,3476972
2016,8,CU,116890,2226436,-2109546
2016,8,CW,0,84516,-84516
2016,8,CY,204208,570362,-366154
2016,8,CZ,16636028,30676086,-14040058
2016,8,KP,0,77275,-77275
2016,8,DK,13911202,15005448,-1094246
2016,8,DJ,0,8302571,-8302571
2016,8,DM,0,421334,-421334
2016,8,DO,309052,3184463,-2875411
2016,8,EC,3024046,1893231,1130815
2016,8,EG,6143749,36953433,-30809684
2016,8,SV,214377,1070147,-855770
2016,8,GQ,0,824879,-824879
2016,8,ER,0,901496,-901496
2016,8,EE,670705,2696546,-2025841
2016,8,ET,13652,12097475,-12083823
2016,8,FK,110724,0,110724
2016,8,FM,0,52663,-52663
2016,8,DE,505834572,469492205,36342367
2016,8,FJ,789243,6019049,-5229806
2016,8,FI,12627246,9726075,2901171
2016,8,FR,107874590,117261559,-9386969
2016,8,GF,0,51968,-51968
2016,8,PF,0,357803,-357803
2016,8,GA,0,2420666,-2420666
2016,8,GM,0,4482114,-4482114
2016,8,GE,252307,691537,-439230
2016,8,GH,17595603,18521626,-926023
2016,8,GR,1190130,5465095,-4274965
2016,8,GD,360,858711,-858351
2016,8,GP,0,81976,-81976
2016,8,GU,0,264089,-264089
2016,8,GT,540469,3468772,-2928303
2016,8,GN,553558,6372644,-5819086
2016,8,GW,0,310000,-310000
2016,8,GY,1078826,436792,642034
2016,8,HT,0,1566510,-1566510
2016,8,HN,26933,1320552,-1293619
2016,8,HK,308418882,769820476,-461401594
2016,8,HU,10579794,24234796,-13655002
2016,8,IS,17855,95290,-77435
2016,8,IN,398231328,812753434,-414522106
2016,8,IQ,0,9512272,-9512272
2016,8,IE,56143822,11420639,44723183
2016,8,IR,2668986,46251680,-43582694
2016,8,IT,113511547,109107819,4403728
2016,8,JM,1793,1989740,-1987947
2016,8,JP,1188020497,1296804438,-108783941
2016,8,JO,12062029,8910852,3151177
2016,8,KZ,914130,4568122,-3653992
2016,8,KE,1497997,18415241,-16917244
2016,8,KI,0,93620,-93620
2016,8,KW,35139458,10465273,24674185
2016,8,KG,0,202852,-202852
2016,8,LV,2799846,8833718,-6033872
2016,8,LB,1349403,4926931,-3577528
2016,8,LR,3878342,5753475,-1875133
2016,8,LY,6549,604663,-598114
2016,8,LI,309083,0,309083
2016,8,LT,8631457,1329736,7301721
2016,8,LU,997944,801891,196053
2016,8,MO,1538604,2569699,-1031095
2016,8,MK,0,15381,-15381
2016,8,MG,226109,9668107,-9441998
2016,8,MW,111805,4592537,-4480732
2016,8,MY,2403605,0,2403605
2016,8,MV,542319,10536370,-9994051
2016,8,ML,0,105378,-105378
2016,8,MT,2694609,1820552,874057
2016,8,MH,0,131702,-131702
2016,8,MQ,0,192194,-192194
2016,8,MR,0,5963153,-5963153
2016,8,MU,240978,7717168,-7476190
2016,8,YT,0,382423,-382423
2016,8,MX,32381487,176988330,-144606843
2016,8,MC,0,100639,-100639
2016,8,ME,2208,91283,-89075
2016,8,MA,2156655,5811252,-3654597
2016,8,MZ,769157,15612551,-14843394
2016,8,NA,149382,334900,-185518
2016,8,NR,0,16612,-16612
2016,8,NP,106114,1587916,-1481802
2016,8,NL,103332430,465562120,-362229690
2016,8,NC,5023,649204,-644181
2016,8,NZ,52583141,51811164,771977
2016,8,NI,59738,250380,-190642
2016,8,NE,0,8497,-8497
2016,8,NG,13011277,83832594,-70821317
2016,8,MP,0,56164,-56164
2016,8,NO,29753994,4889469,24864525
2016,8,OM,10135557,20683453,-10547896
2016,8,ZZ,132230683,1337674,130893009
2016,8,PK,13226642,105877480,-92650838
2016,8,PW,0,14381,-14381
2016,8,PS,13328,0,13328
2016,8,PA,46892,14172436,-14125544
2016,8,PG,29024885,43662764,-14637879
2016,8,PY,862568,551302,311266
2016,8,LA,204296,1483606,-1279310
2016,8,MN,7983,1348926,-1340943
2016,8,CN,3080880823,2314953088,765927735
2016,8,PE,3338171,13001292,-9663121
2016,8,PH,135447412,305722969,-170275557
2016,8,PL,12350595,31281099,-18930504
2016,8,PT,4243659,4835891,-592232
2016,8,PR,60680,1679579,-1618899
2016,8,QA,4507834,11469601,-6961767
2016,8,ID,574613148,619943546,-45330398
2016,8,KR,745050596,396071475,348979121
2016,8,MD,269197,17478,251719
2016,8,SG,1466175375,2486442274,-1020266899
2016,8,ZA,32096335,66679009,-34582674
2016,8,LK,4517562,41106246,-36588684
2016,8,YE,886769,9551106,-8664337
2016,8,RE,0,1223116,-1223116
2016,8,RO,1916698,9773093,-7856395
2016,8,RU,74707175,50691867,24015308
2016,8,RW,1355761,92670,1263091
2016,8,KN,0,34274,-34274
2016,8,LC,0,53317,-53317
2016,8,VC,0,123689,-123689
2016,8,SA,305715705,73629571,232086134
2016,8,SN,0,5475179,-5475179
2016,8,RS,73464,295459,-221995
2016,8,SC,95699,854622,-758923
2016,8,SL,0,408117,-408117
2016,8,SK,2809559,5431140,-2621581
2016,8,SI,2758224,29825440,-27067216
2016,8,VN,442226748,476756150,-34529402
2016,8,SB,1508781,1981519,-472738
2016,8,SO,0,6353241,-6353241
2016,8,ES,47519684,40707689,6811995
2016,8,SD,50526,4192646,-4142120
2016,8,SR,103297,753017,-649720
2016,8,SZ,0,91337,-91337
2016,8,SE,44041815,40117694,3924121
2016,8,CH,138334922,69081331,69253591
2016,8,SY,8620,1929182,-1920562
2016,8,TW,940470409,394142042,546328367
2016,8,TJ,1951,132904,-130953
2016,8,TH,853389821,923190664,-69800843
2016,8,TL,110631,659173,-548542
2016,8,TG,215412,3035046,-2819634
2016,8,TO,0,255243,-255243
2016,8,TT,31639,2366172,-2334533
2016,8,TN,606064,5258875,-4652811
2016,8,TR,22269772,121910869,-99641097
2016,8,TM,0,1247176,-1247176
2016,8,TC,0,4065,-4065
2016,8,TV,0,33243,-33243
2016,8,UG,2099461,432672,1666789
2016,8,UA,10991881,8206225,2785656
2016,8,MM,13491740,94358626,-80866886
2016,8,AE,205783837,247388148,-41604311
2016,8,GB,129692468,169409528,-39717060
2016,8,TZ,20020284,16397107,3623177
2016,8,US,1135799430,1723973957,-588174527
2016,8,UY,1141617,2056020,-914403
2016,8,UZ,178034,3611811,-3433777
2016,8,VU,0,251261,-251261
2016,8,VA,0,11526,-11526
2016,8,VE,334550,1167636,-833086
2016,8,WF,0,11352,-11352
2016,8,WS,0,532945,-532945
2016,8,ZM,17125,244499,-227374
2016,8,ZW,72200,2146467,-2074267
2016,7,AF,4951,6769933,-6764982
2016,7,AL,21406,253957,-232551
2016,7,DZ,472405,7243691,-6771286
2016,7,AS,0,40077,-40077
2016,7,AD,0,9779,-9779
2016,7,AO,215189,16183054,-15967865
2016,7,AG,0,26582,-26582
2016,7,AR,72053450,10421477,61631973
2016,7,AM,2399,731269,-728870
2016,7,AW,1359,84814,-83455
2016,7,AU,233069262,438363035,-205293773
2016,7,AT,43613242,7630618,35982624
2016,7,AZ,1805,53572,-51767
2016,7,BS,2183,104378,-102195
2016,7,BH,1959410,4624823,-2665413
2016,7,BD,13084999,59171611,-46086612
2016,7,BB,11165,75314,-64149
2016,7,BY,5976450,898695,5077755
2016,7,BE,45936269,75119305,-29183036
2016,7,BZ,0,221685,-221685
2016,7,BJ,0,18582336,-18582336
2016,7,BM,0,762,-762
2016,7,BT,1523,87649,-86126
2016,7,BO,447505,524362,-76857
2016,7,BA,0,17799,-17799
2016,7,BW,0,355443,-355443
2016,7,BR,150131172,62593454,87537718
2016,7,VG,0,1193271,-1193271
2016,7,BN,4068111,36218889,-32150778
2016,7,BG,2525391,5684975,-3159584
2016,7,BF,891320,42470,848850
2016,7,BI,0,1742,-1742
2016,7,KH,8126344,21150206,-13023862
2016,7,CM,5980656,1876447,4104209
2016,7,CA,45201004,64892504,-19691500
2016,7,CV,0,168588,-168588
2016,7,KY,0,4017,-4017
2016,7,CF,21390,35803,-14413
2016,7,TD,0,33620,-33620
2016,7,CL,2887808,11805220,-8917412
2016,7,CX,572316,96843,475473
2016,7,CO,664565,5834855,-5170290
2016,7,KM,0,428449,-428449
2016,7,CG,795208,5152951,-4357743
2016,7,CD,6048701,782295,5266406
2016,7,CK,0,28720,-28720
2016,7,CR,1661011,2669021,-1008010
2016,7,CI,15196486,5377684,9818802
2016,7,HR,872451,996111,-123660
2016,7,CU,225373,1501604,-1276231
2016,7,CW,19294,79421,-60127
2016,7,CY,202009,833678,-631669
2016,7,CZ,16885691,23449723,-6564032
2016,7,KP,64975,33934,31041
2016,7,DK,19475460,9654575,9820885
2016,7,DJ,0,6232183,-6232183
2016,7,DM,0,23847,-23847
2016,7,DO,777465,2323165,-1545700
2016,7,EC,2621523,1589847,1031676
2016,7,EG,16959285,44850499,-27891214
2016,7,SV,143137,916071,-772934
2016,7,GQ,0,1707903,-1707903
2016,7,ER,0,771009,-771009
2016,7,EE,364882,1602933,-1238051
2016,7,ET,70969,7080613,-7009644
2016,7,FM,0,40009,-40009
2016,7,DE,512369614,400329734,112039880
2016,7,FJ,238964,5665956,-5426992
2016,7,FI,14745936,8880639,5865297
2016,7,FR,167781675,100103984,67677691
2016,7,GF,0,109334,-109334
2016,7,PF,0,337875,-337875
2016,7,TF,0,1244,-1244
2016,7,GA,69348,3238888,-3169540
2016,7,GM,0,2246490,-2246490
2016,7,GE,511914,2584520,-2072606
2016,7,GH,17555378,3579653,13975725
2016,7,GI,0,64063,-64063
2016,7,GR,1091964,5634692,-4542728
2016,7,GD,15317,2083231,-2067914
2016,7,GP,3377,154184,-150807
2016,7,GU,510,263642,-263132
2016,7,GT,1650853,2771848,-1120995
2016,7,GN,0,2544034,-2544034
2016,7,GW,0,533067,-533067
2016,7,GY,27843,523079,-495236
2016,7,HT,0,730043,-730043
2016,7,HN,11451,1308718,-1297267
2016,7,HK,247383078,691553852,-444170774
2016,7,HU,10812223,29246065,-18433842
2016,7,IS,48,74336,-74288
2016,7,IN,287900740,572473896,-284573156
2016,7,IQ,18281283,8371102,9910181
2016,7,IE,56974642,10411543,46563099
2016,7,IR,11733970,59182869,-47448899
2016,7,IT,156739468,84985389,71754079
2016,7,JM,25301,1401521,-1376220
2016,7,JP,1173324836,1253576865,-80252029
2016,7,JO,2437553,5496351,-3058798
2016,7,KZ,94613,5683923,-5589310
2016,7,KE,634234,12496209,-11861975
2016,7,KI,0,146504,-146504
2016,7,KW,20553959,14724006,5829953
2016,7,KG,0,92650,-92650
2016,7,LV,211473,5549999,-5338526
2016,7,LB,548852,4846654,-4297802
2016,7,LS,0,103539,-103539
2016,7,LR,1727792,2196443,-468651
2016,7,LY,237387,952359,-714972
2016,7,LI,0,23758,-23758
2016,7,LT,957196,3146575,-2189379
2016,7,LU,930106,513684,416422
2016,7,MO,1157506,1307642,-150136
2016,7,MK,2815,21016,-18201
2016,7,MG,321795,6033543,-5711748
2016,7,MW,582120,4448374,-3866254
2016,7,MY,1339954,0,1339954
2016,7,MV,6044,8394047,-8388003
2016,7,ML,0,445430,-445430
2016,7,MT,2492016,1865761,626255
2016,7,MH,0,93908,-93908
2016,7,MQ,0,59587,-59587
2016,7,MR,0,5348833,-5348833
2016,7,MU,471900,6616085,-6144185
2016,7,YT,0,231875,-231875
2016,7,MX,31311559,151219035,-119907476
2016,7,ME,0,119086,-119086
2016,7,MA,1814691,7248755,-5434064
2016,7,MZ,267942,16382524,-16114582
2016,7,NA,177356,172759,4597
2016,7,NR,0,13151,-13151
2016,7,NP,24844,1594102,-1569258
2016,7,NL,109638298,426577771,-316939473
2016,7,NC,0,1945409,-1945409
2016,7,NZ,55619936,43962449,11657487
2016,7,NI,75659,431432,-355773
2016,7,NE,0,52574,-52574
2016,7,NG,7362723,113254293,-105891570
2016,7,MP,0,79205,-79205
2016,7,NO,18784757,6745309,12039448
2016,7,OM,37337272,13527289,23809983
2016,7,ZZ,198744045,2230841,196513204
2016,7,PK,15772860,90057380,-74284520
2016,7,PS,4629,40320,-35691
2016,7,PA,159332,12365048,-12205716
2016,7,PG,17909685,22657007,-4747322
2016,7,PY,315364,617507,-302143
2016,7,LA,2045501,914821,1130680
2016,7,MN,1979,1330559,-1328580
2016,7,CN,2854525531,1812119581,1042405950
2016,7,PE,9972853,7155982,2816871
2016,7,PH,146310317,257910828,-111600511
2016,7,PL,15187405,19002774,-3815369
2016,7,PT,3576158,5068492,-1492334
2016,7,PR,648602,1411533,-762931
2016,7,QA,84381359,12925041,71456318
2016,7,ID,465161386,522910619,-57749233
2016,7,KR,1488239262,387044102,1101195160
2016,7,MD,351200,0,351200
2016,7,SG,1456698375,2277493759,-820795384
2016,7,ZA,24171006,48093697,-23922691
2016,7,LK,4212945,51881192,-47668247
2016,7,YE,413995,9875864,-9461869
2016,7,RE,728065,2245315,-1517250
2016,7,RO,2261618,10496521,-8234903
2016,7,RU,127051560,35859338,91192222
2016,7,RW,1635569,7300,1628269
2016,7,LC,0,50038,-50038
2016,7,VC,0,72227,-72227
2016,7,SA,140850069,70141880,70708189
2016,7,SN,365841,5523139,-5157298
2016,7,RS,71628,621114,-549486
2016,7,SC,0,1030589,-1030589
2016,7,SL,0,872237,-872237
2016,7,SK,2703269,4704816,-2001547
2016,7,SI,1458369,16565101,-15106732
2016,7,VN,307849537,448977339,-141127802
2016,7,SB,3036680,3702052,-665372
2016,7,SO,0,6926903,-6926903
2016,7,ES,38892883,62417552,-23524669
2016,7,SD,9964,1917034,-1907070
2016,7,SR,100140,369285,-269145
2016,7,SZ,5837,186085,-180248
2016,7,SE,46789424,28275469,18513955
2016,7,CH,83370332,57864635,25505697
2016,7,SY,14234,1269814,-1255580
2016,7,TW,972191528,422585531,549605997
2016,7,TJ,0,80181,-80181
2016,7,TH,804212689,886066947,-81854258
2016,7,TL,23243,888712,-865469
2016,7,TG,0,5030156,-5030156
2016,7,TO,0,151516,-151516
2016,7,TT,28088,2278670,-2250582
2016,7,TN,733329,9114942,-8381613
2016,7,TR,43836398,131115522,-87279124
2016,7,TM,703318,3574031,-2870713
2016,7,TC,0,11362,-11362
2016,7,TV,0,70730,-70730
2016,7,UG,870277,796792,73485
2016,7,UA,5677209,12694240,-7017031
2016,7,MM,20668681,69727136,-49058455
2016,7,AE,136822639,206801329,-69978690
2016,7,GB,124366584,165309853,-40943269
2016,7,TZ,11053798,30108171,-19054373
2016,7,US,1030601313,1579688796,-549087483
2016,7,VI,1437,0,1437
2016,7,UY,2496490,1936498,559992
2016,7,UZ,267,4109535,-4109268
2016,7,VU,131444,228418,-96974
2016,7,VA,0,1489,-1489
2016,7,VE,23964452,999323,22965129
2016,7,WF,0,13876,-13876
2016,7,WS,0,262649,-262649
2016,7,ZM,471855,80729,391126
2016,7,ZW,40834,558709,-517875
2016,6,AF,2604,8406931,-8404327
2016,6,AL,25349,441485,-416136
2016,6,DZ,96747,10769784,-10673037
2016,6,AS,0,256099,-256099
2016,6,AD,0,14516,-14516
2016,6,AO,59634,25319568,-25259934
2016,6,AG,0,65202,-65202
2016,6,AR,103244884,18134322,85110562
2016,6,AM,8361,352548,-344187
2016,6,AW,0,196618,-196618
2016,6,AU,320865885,592043784,-271177899
2016,6,AT,53102663,6031032,47071631
2016,6,AZ,32512,324792,-292280
2016,6,BS,7048,397279,-390231
2016,6,BH,2812351,6172702,-3360351
2016,6,BD,19622759,149837329,-130214570
2016,6,BB,4847,178136,-173289
2016,6,BY,2831799,151715,2680084
2016,6,BE,60048915,82283356,-22234441
2016,6,BZ,20748,248319,-227571
2016,6,BJ,0,19166111,-19166111
2016,6,BM,0,148617,-148617
2016,6,BT,0,342625,-342625
2016,6,BO,1322644,779537,543107
2016,6,BA,6047,15491,-9444
2016,6,BW,0,144478,-144478
2016,6,BR,139246112,68722104,70524008
2016,6,IO,0,661,-661
2016,6,VG,105990,3807045,-3701055
2016,6,BN,17536627,46831893,-29295266
2016,6,BG,2614344,4690831,-2076487
2016,6,BF,0,300000,-300000
2016,6,KH,12023599,28103493,-16079894
2016,6,CM,6061119,1832864,4228255
2016,6,CA,50645183,69727680,-19082497
2016,6,CV,0,159767,-159767
2016,6,KY,0,19085,-19085
2016,6,CF,0,53867,-53867
2016,6,TD,0,3556,-3556
2016,6,CL,4945923,10722302,-5776379
2016,6,CX,741277,103827,637450
2016,6,CO,2511332,6966110,-4454778
2016,6,KM,0,120413,-120413
2016,6,CG,3684018,7608555,-3924537
2016,6,CD,5068603,1042147,4026456
2016,6,CR,2311701,4074798,-1763097
2016,6,CI,9262398,6806126,2456272
2016,6,HR,220344,1904103,-1683759
2016,6,CU,181116,2811317,-2630201
2016,6,CW,4402,13811,-9409
2016,6,CY,509013,1265969,-756956
2016,6,CZ,16124264,28861819,-12737555
2016,6,KP,209488,246918,-37430
2016,6,DK,17939384,8777316,9162068
2016,6,DJ,0,8605255,-8605255
2016,6,DM,0,91423,-91423
2016,6,DO,90078,2896961,-2806883
2016,6,EC,5909532,1635698,4273834
2016,6,EG,25024599,32030649,-7006050
2016,6,SV,0,1249853,-1249853
2016,6,GQ,0,294099,-294099
2016,6,EE,641745,2085776,-1444031
2016,6,ET,13361,11292196,-11278835
2016,6,FM,0,12086,-12086
2016,6,DE,483866340,437395951,46470389
2016,6,FJ,26267,5363195,-5336928
2016,6,FI,15496658,8809955,6686703
2016,6,FR,117007372,126557559,-9550187
2016,6,PF,0,237376,-237376
2016,6,GA,27514,2752910,-2725396
2016,6,GM,0,1999522,-1999522
2016,6,GE,578274,1250557,-672283
2016,6,GH,14950425,22366667,-7416242
2016,6,GI,0,6204,-6204
2016,6,GR,1316098,7032318,-5716220
2016,6,GL,2370,0,2370
2016,6,GD,93426,1323527,-1230101
2016,6,GP,16258,42252,-25994
2016,6,GU,4666,336019,-331353
2016,6,GT,1828224,2773613,-945389
2016,6,GN,0,7863707,-7863707
2016,6,GW,0,639414,-639414
2016,6,GY,74607,605258,-530651
2016,6,HT,2623,874044,-871421
2016,6,HN,60596,1926910,-1866314
2016,6,HK,234167414,827798229,-593630815
2016,6,HU,14835464,28750541,-13915077
2016,6,IS,16970,398088,-381118
2016,6,IN,277290863,628159773,-350868910
2016,6,IQ,381136,9456994,-9075858
2016,6,IE,53108316,10016494,43091822
2016,6,IR,2515991,53880861,-51364870
2016,6,IT,138947453,88398683,50548770
2016,6,JM,33370,1331406,-1298036
2016,6,JP,1220115112,1216612481,3502631
2016,6,JO,9589956,6410692,3179264
2016,6,KZ,608892,4318706,-3709814
2016,6,KE,785392,15215714,-14430322
2016,6,KI,0,91619,-91619
2016,6,KW,35677280,15508224,20169056
2016,6,KG,0,127896,-127896
2016,6,LV,3623799,4386811,-763012
2016,6,LB,521634,4752727,-4231093
2016,6,LS,1958,0,1958
2016,6,LR,306281,3514706,-3208425
2016,6,LY,86098,572802,-486704
2016,6,LI,31770,248678,-216908
2016,6,LT,1690383,3771623,-2081240
2016,6,LU,1029492,997072,32420
2016,6,MO,1253267,1661998,-408731
2016,6,MK,188918,15763,173155
2016,6,MG,558184,8358931,-7800747
2016,6,MW,805511,320814,484697
2016,6,MY,1264575,0,1264575
2016,6,MV,1435,9387704,-9386269
2016,6,ML,0,119475,-119475
2016,6,MT,2916536,3082430,-165894
2016,6,MH,0,34052,-34052
2016,6,MQ,0,117549,-117549
2016,6,MR,393,4119886,-4119493
2016,6,MU,125143,7826156,-7701013
2016,6,YT,0,274748,-274748
2016,6,MX,28567108,169092083,-140524975
2016,6,MC,115,0,115
2016,6,ME,0,65996,-65996
2016,6,MA,1844071,5027157,-3183086
2016,6,MZ,462392,16595909,-16133517
2016,6,NA,65484,654832,-589348
2016,6,NP,53411,3292512,-3239101
2016,6,NL,151858655,442490087,-290631432
2016,6,NC,0,871287,-871287
2016,6,NZ,54199274,46925190,7274084
2016,6,NI,79306,491429,-412123
2016,6,NE,0,81960,-81960
2016,6,NG,11280738,44652944,-33372206
2016,6,NF,0,3245,-3245
2016,6,MP,0,88227,-88227
2016,6,NO,11372916,5982454,5390462
2016,6,OM,15036892,30718506,-15681614
2016,6,ZZ,175696573,2310936,173385637
2016,6,PK,13924497,114512984,-100588487
2016,6,PW,0,97869,-97869
2016,6,PS,11561,35367,-23806
2016,6,PA,401686,6709608,-6307922
2016,6,PG,12739544,23067241,-10327697
2016,6,PY,1906967,752331,1154636
2016,6,LA,464223,1077238,-613015
2016,6,MN,906,1000902,-999996
2016,6,CN,3236289669,1881793225,1354496444
2016,6,PE,7385567,13571228,-6185661
2016,6,PH,135825087,266509471,-130684384
2016,6,PL,15064285,24242014,-9177729
2016,6,PT,2657680,5779691,-3122011
2016,6,PR,275525,974577,-699052
2016,6,QA,30469557,13243376,17226181
2016,6,ID,605708649,472216819,133491830
2016,6,KR,672025557,433967953,238057604
2016,6,MD,485478,6888,478590
2016,6,SG,1665229749,2408595392,-743365643
2016,6,ZA,43361704,78224658,-34862954
2016,6,LK,8545876,61968426,-53422550
2016,6,YE,819658,7732182,-6912524
2016,6,RE,0,1313201,-1313201
2016,6,RO,2078895,8563863,-6484968
2016,6,RU,122132902,45775910,76356992
2016,6,RW,1403865,183862,1220003
2016,6,LC,0,71620,-71620
2016,6,SA,234811675,56767449,178044226
2016,6,SN,0,6600800,-6600800
2016,6,RS,80697,387763,-307066
2016,6,SC,36982,7203783,-7166801
2016,6,SL,2273,493473,-491200
2016,6,SX,0,20814,-20814
2016,6,SK,2389216,3505271,-1116055
2016,6,SI,1520146,14545087,-13024941
2016,6,VN,452422506,657863891,-205441385
2016,6,SB,1832828,1707796,125032
2016,6,SO,0,4516331,-4516331
2016,6,ES,40704034,48698288,-7994254
2016,6,SD,36702,3265185,-3228483
2016,6,SR,44728,318424,-273696
2016,6,SZ,3084,61741,-58657
2016,6,SE,44530356,23309078,21221278
2016,6,CH,131850851,84621022,47229829
2016,6,SY,15061,1033284,-1018223
2016,6,TW,854475158,435597904,418877254
2016,6,TJ,1925,91972,-90047
2016,6,TH,854026088,919207156,-65181068
2016,6,TL,38339,545667,-507328
2016,6,TG,0,5498522,-5498522
2016,6,TK,3786,0,3786
2016,6,TO,0,233969,-233969
2016,6,TT,72640,2164367,-2091727
2016,6,TN,1183759,3805174,-2621415
2016,6,TR,35780698,139064702,-103284004
2016,6,TM,1856,4912232,-4910376
2016,6,TV,2779,195623,-192844
2016,6,UM,0,320416,-320416
2016,6,UG,4383710,1037978,3345732
2016,6,UA,5560599,5642882,-82283
2016,6,MM,16754431,93802073,-77047642
2016,6,AE,219530373,292108999,-72578626
2016,6,GB,143218975,188057266,-44838291
2016,6,TZ,30763860,7988206,22775654
2016,6,US,1244753884,1722693423,-477939539
2016,6,VI,136582,0,136582
2016,6,UY,2621517,939108,1682409
2016,6,UZ,72910,3538904,-3465994
2016,6,VU,106910,45073,61837
2016,6,VE,27178848,9282923,17895925
2016,6,WS,0,310824,-310824
2016,6,ZM,569239,819624,-250385
2016,6,ZW,205830,381739,-175909
2016,5,AF,31773,4436456,-4404683
2016,5,AL,63337,260988,-197651
2016,5,DZ,100887,7851612,-7750725
2016,5,AS,20771,5170675,-5149904
2016,5,AD,882,19253,-18371
2016,5,AO,30939,7826013,-7795074
2016,5,AI,0,448,-448
2016,5,AG,16820,50979,-34159
2016,5,AR,36429202,39740495,-3311293
2016,5,AM,0,225028,-225028
2016,5,AW,0,2521,-2521
2016,5,AU,335115065,479619365,-144504300
2016,5,AT,50697208,9340610,41356598
2016,5,AZ,0,1187467,-1187467
2016,5,BS,0,487091,-487091
2016,5,BH,30199108,6500678,23698430
2016,5,BD,16755738,142357963,-125602225
2016,5,BB,3460,249335,-245875
2016,5,BY,4762635,351131,4411504
2016,5,BE,101149614,85917671,15231943
2016,5,BZ,0,165329,-165329
2016,5,BJ,13278,25876187,-25862909
2016,5,BM,0,3500,-3500
2016,5,BT,270,46616,-46346
2016,5,BO,841645,114443,727202
2016,5,BA,3173,46422,-43249
2016,5,BW,0,112356,-112356
2016,5,BR,66587192,39373566,27213626
2016,5,VG,120321,3843628,-3723307
2016,5,BN,23515462,49234165,-25718703
2016,5,BG,2001621,4444077,-2442456
2016,5,BF,295770,852254,-556484
2016,5,KH,10647224,20086249,-9439025
2016,5,CM,3904574,1921808,1982766
2016,5,CA,70043078,52693652,17349426
2016,5,CV,0,2397,-2397
2016,5,KY,0,118492,-118492
2016,5,CF,0,178221,-178221
2016,5,TD,0,34484,-34484
2016,5,CL,11392618,19632679,-8240061
2016,5,CX,0,17121,-17121
2016,5,CO,1139859,5322444,-4182585
2016,5,KM,0,204289,-204289
2016,5,CG,857919,4329435,-3471516
2016,5,CD,3786231,581877,3204354
2016,5,CK,0,9342,-9342
2016,5,CR,1406829,4218044,-2811215
2016,5,CI,25069548,6255837,18813711
2016,5,HR,3532986,1387134,2145852
2016,5,CU,177033,1487277,-1310244
2016,5,CW,0,19120,-19120
2016,5,CY,2559587,1112338,1447249
2016,5,CZ,19251452,23970347,-4718895
2016,5,KP,44257,593324,-549067
2016,5,DK,17256351,8960851,8295500
2016,5,DJ,0,5221068,-5221068
2016,5,DM,0,41159,-41159
2016,5,DO,96280,2354150,-2257870
2016,5,EC,3647565,935778,2711787
2016,5,EG,7610478,39417718,-31807240
2016,5,SV,161132,1788513,-1627381
2016,5,GQ,0,222681,-222681
2016,5,ER,0,217506,-217506
2016,5,EE,907703,1172845,-265142
2016,5,ET,341522,9950128,-9608606
2016,5,FM,8438,52010,-43572
2016,5,DE,471104322,432057787,39046535
2016,5,FJ,116999,2824876,-2707877
2016,5,FI,13492900,6671906,6820994
2016,5,FR,433127673,115745866,317381807
2016,5,GF,0,35859,-35859
2016,5,PF,0,2334621,-2334621
2016,5,GA,25679877,6158597,19521280
2016,5,GM,0,1615151,-1615151
2016,5,GE,104284,2355820,-2251536
2016,5,GH,22904357,16895244,6009113
2016,5,GI,0,30505,-30505
2016,5,GR,559089,4430109,-3871020
2016,5,GL,7421,0,7421
2016,5,GD,0,558020,-558020
2016,5,GP,0,69515,-69515
2016,5,GU,10983,163438,-152455
2016,5,GT,125290,2082718,-1957428
2016,5,GN,207488,802299,-594811
2016,5,GW,0,340265,-340265
2016,5,GY,93020,724144,-631124
2016,5,HT,2055,1029527,-1027472
2016,5,HN,33030,3307605,-3274575
2016,5,HK,264430355,726592100,-462161745
2016,5,HU,12196022,22184586,-9988564
2016,5,IS,154591,57495,97096
2016,5,IN,300388422,676553890,-376165468
2016,5,IQ,56562,10190539,-10133977
2016,5,IE,50118032,12632537,37485495
2016,5,IR,4034330,25194682,-21160352
2016,5,IT,135613773,73503586,62110187
2016,5,JM,7310,1668727,-1661417
2016,5,JP,1024259595,1057141654,-32882059
2016,5,JO,1232139,6523724,-5291585
2016,5,KZ,1301,3810067,-3808766
2016,5,KE,798256,17329058,-16530802
2016,5,KI,0,79518,-79518
2016,5,KW,16349442,15691212,658230
2016,5,KG,0,137325,-137325
2016,5,LV,492818,2734279,-2241461
2016,5,LB,1774155,5166176,-3392021
2016,5,LS,21998,227036,-205038
2016,5,LR,1742,4485896,-4484154
2016,5,LY,158190,1096722,-938532
2016,5,LI,6490,30011,-23521
2016,5,LT,6730219,3278480,3451739
2016,5,LU,4026759,657235,3369524
2016,5,MO,1037829,3240563,-2202734
2016,5,MK,230052,359764,-129712
2016,5,MG,561601,7687231,-7125630
2016,5,MW,351234,650041,-298807
2016,5,MY,1408380,0,1408380
2016,5,MV,5935,10536524,-10530589
2016,5,ML,10124,313954,-303830
2016,5,MT,2548776,2332959,215817
2016,5,MH,0,54585,-54585
2016,5,MQ,0,104009,-104009
2016,5,MR,668,1447346,-1446678
2016,5,MU,158964,6897917,-6738953
2016,5,YT,0,347052,-347052
2016,5,MX,29811057,161044302,-131233245
2016,5,MC,2324,398,1926
2016,5,ME,12935,39556,-26621
2016,5,MA,1614007,6912223,-5298216
2016,5,MZ,85395,1939150,-1853755
2016,5,NA,0,258658,-258658
2016,5,NP,60310,1615148,-1554838
2016,5,NL,162666757,371999722,-209332965
2016,5,NC,5035,338096,-333061
2016,5,NZ,60611898,70172514,-9560616
2016,5,NI,51833,1073463,-1021630
2016,5,NE,0,484698,-484698
2016,5,NG,7120393,49481700,-42361307
2016,5,NF,0,34452,-34452
2016,5,MP,0,119185,-119185
2016,5,NO,14542134,7136661,7405473
2016,5,OM,19987501,20873446,-885945
2016,5,ZZ,101714148,595279,101118869
2016,5,PK,15999055,117371988,-101372933
2016,5,PW,0,5111,-5111
2016,5,PS,10047,35142,-25095
2016,5,PA,97815,7738578,-7640763
2016,5,PG,7199631,15142871,-7943240
2016,5,PY,1485705,456226,1029479
2016,5,LA,364654,1752744,-1388090
2016,5,MN,3848,1706456,-1702608
2016,5,CN,2959664158,1750743409,1208920749
2016,5,PE,3783676,7501259,-3717583
2016,5,PH,123431004,268954674,-145523670
2016,5,PL,16921798,19420807,-2499009
2016,5,PT,3384521,5931379,-2546858
2016,5,PR,688918,2631170,-1942252
2016,5,QA,27496396,16121612,11374784
2016,5,ID,545120275,563371369,-18251094
2016,5,KR,727267626,386248307,341019319
2016,5,MD,334934,598,334336
2016,5,SG,1372566851,2098509151,-725942300
2016,5,ZA,37841072,37265020,576052
2016,5,LK,3975610,45394044,-41418434
2016,5,YE,1140267,15375194,-14234927
2016,5,RE,0,2226729,-2226729
2016,5,RO,1661769,8260745,-6598976
2016,5,RU,46227620,37163856,9063764
2016,5,RW,1963129,129648,1833481
2016,5,KN,0,34727,-34727
2016,5,LC,0,16131,-16131
2016,5,VC,0,13466,-13466
2016,5,ST,0,36466,-36466
2016,5,SA,219877441,68125048,151752393
2016,5,SN,254790,3451841,-3197051
2016,5,RS,158059,360126,-202067
2016,5,SC,298,790346,-790048
2016,5,SL,0,403301,-403301
2016,5,SK,2604343,4103410,-1499067
2016,5,SI,2365965,24247421,-21881456
2016,5,VN,349859205,543272003,-193412798
2016,5,SB,1850858,2202717,-351859
2016,5,SO,0,6503729,-6503729
2016,5,ES,42327708,65735934,-23408226
2016,5,SD,61079,3230911,-3169832
2016,5,SR,47078,211196,-164118
2016,5,SZ,71251,126745,-55494
2016,5,SE,44729347,26917069,17812278
2016,5,CH,144848345,29275233,115573112
2016,5,SY,25294,3035461,-3010167
2016,5,TW,827029746,392625982,434403764
2016,5,TJ,0,136181,-136181
2016,5,TH,876145593,851952060,24193533
2016,5,TL,6558,320375,-313817
2016,5,TG,5679,5893017,-5887338
2016,5,TO,0,257752,-257752
2016,5,TT,6658,1627145,-1620487
2016,5,TN,6924746,6497454,427292
2016,5,TR,18884315,131837767,-112953452
2016,5,TM,5156,966489,-961333
2016,5,TC,0,16384,-16384
2016,5,TV,1091,44826,-43735
2016,5,UM,0,2241,-2241
2016,5,UG,6115055,1236703,4878352
2016,5,UA,7558498,5332900,2225598
2016,5,MM,20824832,59293002,-38468170
2016,5,AE,185310923,247914590,-62603667
2016,5,GB,130688807,186078314,-55389507
2016,5,TZ,1290892,7032725,-5741833
2016,5,US,1168632987,1576810831,-408177844
2016,5,VI,610,3335,-2725
2016,5,UY,403569,1234763,-831194
2016,5,UZ,20660,15924583,-15903923
2016,5,VU,255827,5465045,-5209218
2016,5,VE,18250552,1426644,16823908
2016,5,WS,164583,579076,-414493
2016,5,ZM,302394,148715,153679
2016,5,ZW,2200,1320504,-1318304
2016,4,AF,237,4906330,-4906093
2016,4,AL,4300,276585,-272285
2016,4,DZ,46442,11533224,-11486782
2016,4,AS,0,356558,-356558
2016,4,AO,1731,9618559,-9616828
2016,4,AI,0,604,-604
2016,4,AG,4077,138272,-134195
2016,4,AR,97271421,12866099,84405322
2016,4,AM,0,6486,-6486
2016,4,AW,0,50134,-50134
2016,4,AU,311054953,614947031,-303892078
2016,4,AT,41652961,14146660,27506301
2016,4,AZ,0,806523,-806523
2016,4,BS,0,546743,-546743
2016,4,BH,6937796,6689098,248698
2016,4,BD,18534806,140953716,-122418910
2016,4,BB,4528,268092,-263564
2016,4,BY,3379392,72582,3306810
2016,4,BE,50336769,89745782,-39409013
2016,4,BZ,0,269218,-269218
2016,4,BJ,0,33867766,-33867766
2016,4,BM,0,3494,-3494
2016,4,BT,7693,40625,-32932
2016,4,BO,3002829,689775,2313054
2016,4,BA,418,16353,-15935
2016,4,BW,0,608547,-608547
2016,4,BR,91164561,57617478,33547083
2016,4,VG,145385,0,145385
2016,4,BN,32166354,46864976,-14698622
2016,4,BG,3787411,6484148,-2696737
2016,4,BF,475616,13412,462204
2016,4,BI,0,52684,-52684
2016,4,KH,6992555,21487495,-14494940
2016,4,CM,6658587,4748115,1910472
2016,4,CA,67536978,55321198,12215780
2016,4,CV,0,43271,-43271
2016,4,KY,0,1496,-1496
2016,4,CF,110278,32693,77585
2016,4,CL,5640215,11231297,-5591082
2016,4,CX,796099,17878,778221
2016,4,CO,2010613,6236126,-4225513
2016,4,KM,0,471995,-471995
2016,4,CG,3774123,4290451,-516328
2016,4,CD,3100884,2313497,787387
2016,4,CK,0,30397,-30397
2016,4,CR,1927644,3619020,-1691376
2016,4,CI,20257000,5873202,14383798
2016,4,HR,385272,1376703,-991431
2016,4,CU,36848,6392183,-6355335
2016,4,CW,46405,12986,33419
2016,4,CY,6277143,922675,5354468
2016,4,CZ,20430267,31481392,-11051125
2016,4,KP,1713374,564043,1149331
2016,4,DK,18589070,13190924,5398146
2016,4,DJ,87299,10698912,-10611613
2016,4,DM,0,92743,-92743
2016,4,DO,276999,2280379,-2003380
2016,4,EC,1972720,1503997,468723
2016,4,EG,8059623,47911495,-39851872
2016,4,SV,319644,1447543,-1127899
2016,4,GQ,0,1345384,-1345384
2016,4,ER,0,1222824,-1222824
2016,4,EE,225151,2614367,-2389216
2016,4,ET,10221,4233222,-4223001
2016,4,FM,1816,24816,-23000
2016,4,DE,498742452,445560013,53182439
2016,4,FJ,68462,4577964,-4509502
2016,4,FI,12954558,7125599,5828959
2016,4,FR,159028926,119369625,39659301
2016,4,GF,0,54347,-54347
2016,4,PF,0,297039,-297039
2016,4,GA,2525222,3088913,-563691
2016,4,GM,0,1457553,-1457553
2016,4,GE,174455,4571324,-4396869
2016,4,GH,20517350,22186153,-1668803
2016,4,GI,0,3742,-3742
2016,4,GR,10683553,7331245,3352308
2016,4,GD,0,1032161,-1032161
2016,4,GP,0,280216,-280216
2016,4,GU,25863,239026,-213163
2016,4,GT,18645761,1949498,16696263
2016,4,GN,1092,7485578,-7484486
2016,4,GW,0,340349,-340349
2016,4,GY,57630,342102,-284472
2016,4,HT,57206,405522,-348316
2016,4,HN,197380,9029964,-8832584
2016,4,HK,269718257,798835811,-529117554
2016,4,HU,9990529,23484162,-13493633
2016,4,IS,359782,66376,293406
2016,4,IN,256107434,592185707,-336078273
2016,4,IQ,0,6566696,-6566696
2016,4,IE,31366260,9577021,21789239
2016,4,IR,3528004,28389355,-24861351
2016,4,IT,95748759,91891657,3857102
2016,4,JM,0,1585138,-1585138
2016,4,JP,1177036733,1132692757,44343976
2016,4,JO,6517722,9231488,-2713766
2016,4,KZ,159302,4165747,-4006445
2016,4,KE,440533,12652497,-12211964
2016,4,KI,0,94086,-94086
2016,4,KW,36381876,15086656,21295220
2016,4,KG,35004,341609,-306605
2016,4,LV,733514,2348945,-1615431
2016,4,LB,459187,5975983,-5516796
2016,4,LS,0,427102,-427102
2016,4,LR,745360,7287985,-6542625
2016,4,LY,106489,885519,-779030
2016,4,LI,20935,280666,-259731
2016,4,LT,4434192,1812727,2621465
2016,4,LU,1653365,723646,929719
2016,4,MO,742573,2135064,-1392491
2016,4,MK,283092,17851,265241
2016,4,MG,961358,4706137,-3744779
2016,4,MW,657133,397675,259458
2016,4,MY,1764256,0,1764256
2016,4,MV,12774,10114521,-10101747
2016,4,ML,0,152232,-152232
2016,4,MT,4274897,2043602,2231295
2016,4,MH,0,93024,-93024
2016,4,MQ,0,146710,-146710
2016,4,MR,35241,4241080,-4205839
2016,4,MU,513272,6806762,-6293490
2016,4,YT,0,661056,-661056
2016,4,MX,24316231,172392101,-148075870
2016,4,MC,0,8626,-8626
2016,4,ME,2925,26331,-23406
2016,4,MA,1991761,4989716,-2997955
2016,4,MZ,349020,20184204,-19835184
2016,4,NA,337842,189471,148371
2016,4,NR,0,108075,-108075
2016,4,NP,19728,2957360,-2937632
2016,4,NL,154364350,344592224,-190227874
2016,4,NC,0,14677923,-14677923
2016,4,NZ,51235381,42539261,8696120
2016,4,NI,69258,464239,-394981
2016,4,NE,0,1148406,-1148406
2016,4,NG,6367461,91577173,-85209712
2016,4,NF,52638,0,52638
2016,4,MP,428,21164,-20736
2016,4,NO,39905731,9237031,30668700
2016,4,OM,11173991,21873002,-10699011
2016,4,ZZ,136090117,637551,135452566
2016,4,PK,21177577,94259461,-73081884
2016,4,PW,0,133972,-133972
2016,4,PS,14356,993,13363
2016,4,PA,45514,8368354,-8322840
2016,4,PG,3125434,50443286,-47317852
2016,4,PY,1798,267195,-265397
2016,4,LA,252349,2527995,-2275646
2016,4,MN,4081,1335945,-1331864
2016,4,CN,2767972926,1728206739,1039766187
2016,4,PE,1772062,7205639,-5433577
2016,4,PH,136573637,272812897,-136239260
2016,4,PL,13746493,22252155,-8505662
2016,4,PT,3477004,5982773,-2505769
2016,4,PR,549785,1398949,-849164
2016,4,QA,11365581,11633753,-268172
2016,4,ID,617180683,616190928,989755
2016,4,KR,619332031,458311744,161020287
2016,4,MD,290722,49167,241555
2016,4,SG,1388198618,2343151544,-954952926
2016,4,ZA,27408897,64314044,-36905147
2016,4,LK,3903783,38945095,-35041312
2016,4,YE,881989,12548446,-11666457
2016,4,RE,0,803004,-803004
2016,4,RO,2385376,9417756,-7032380
2016,4,RU,68454577,42001998,26452579
2016,4,RW,712600,0,712600
2016,4,KN,0,10633,-10633
2016,4,LC,0,15739,-15739
2016,4,VC,0,14077,-14077
2016,4,ST,0,28171,-28171
2016,4,SA,212331591,63840309,148491282
2016,4,SN,3162723,4535178,-1372455
2016,4,RS,520832,538781,-17949
2016,4,SC,45489,1146161,-1100672
2016,4,SL,0,880910,-880910
2016,4,SK,3601169,4940977,-1339808
2016,4,SI,2321285,17251759,-14930474
2016,4,VN,248200417,539758483,-291558066
2016,4,SB,59979,8861180,-8801201
2016,4,SO,0,8273417,-8273417
2016,4,ES,33385947,32304037,1081910
2016,4,SD,36822,4165430,-4128608
2016,4,SR,61782,177469,-115687
2016,4,SW,1715802,0,1715802
2016,4,SZ,0,77057,-77057
2016,4,SE,35835164,32448527,3386637
2016,4,CH,96460843,22084094,74376749
2016,4,SY,0,3698975,-3698975
2016,4,TW,793614657,488320903,305293754
2016,4,TJ,0,193877,-193877
2016,4,TH,843203150,809975104,33228046
2016,4,TL,32156,597846,-565690
2016,4,TG,0,13029735,-13029735
2016,4,TK,25473,0,25473
2016,4,TO,2754,185947,-183193
2016,4,TT,4810,3282366,-3277556
2016,4,TN,5283650,9260939,-3977289
2016,4,TR,20617625,94808155,-74190530
2016,4,TM,1088,329170,-328082
2016,4,TV,0,22618,-22618
2016,4,UM,0,2123,-2123
2016,4,UG,2728814,610058,2118756
2016,4,UA,4756750,4897881,-141131
2016,4,MM,14400694,57586244,-43185550
2016,4,AE,175116697,306686054,-131569357
2016,4,GB,139060136,173772997,-34712861
2016,4,TZ,7911293,40736424,-32825131
2016,4,US,1148798267,1698220766,-549422499
2016,4,UY,810962,1417149,-606187
2016,4,UZ,0,15193900,-15193900
2016,4,VU,20181,146461,-126280
2016,4,VE,15759669,6598299,9161370
2016,4,WS,0,363304,-363304
2016,4,ZM,125274,79604,45670
2016,4,ZW,317518,867227,-549709
2016,3,AF,2982,5163904,-5160922
2016,3,AL,65215,198939,-133724
2016,3,DZ,53232,10799646,-10746414
2016,3,AS,0,78105,-78105
2016,3,AO,10852,9548072,-9537220
2016,3,AI,25962,0,25962
2016,3,AG,197985,102420,95565
2016,3,AR,95716744,13569948,82146796
2016,3,AM,92479,605109,-512630
2016,3,AW,0,363389,-363389
2016,3,AU,314963044,599760297,-284797253
2016,3,AT,50632500,10530838,40101662
2016,3,AZ,48116,521004,-472888
2016,3,BS,0,624886,-624886
2016,3,BH,14734301,5822978,8911323
2016,3,BD,21807606,109826344,-88018738
2016,3,BB,2397,131499,-129102
2016,3,BY,330739,176946,153793
2016,3,BE,48324827,78020969,-29696142
2016,3,BZ,0,220586,-220586
2016,3,BJ,86,30703857,-30703771
2016,3,BM,0,1304,-1304
2016,3,BT,7715,73014,-65299
2016,3,BO,2830337,470658,2359679
2016,3,BA,0,813,-813
2016,3,BW,0,271677,-271677
2016,3,BR,212359557,65608255,146751302
2016,3,VG,283255,0,283255
2016,3,BN,1946618,46622058,-44675440
2016,3,BG,1972455,5097223,-3124768
2016,3,BF,1434205,2169,1432036
2016,3,KH,12758233,30043866,-17285633
2016,3,CM,5859477,1171021,4688456
2016,3,CA,60696168,58920247,1775921
2016,3,CV,0,75327,-75327
2016,3,KY,1263,21086,-19823
2016,3,CF,19430,144271,-124841
2016,3,TD,0,550,-550
2016,3,CL,6338737,11401494,-5062757
2016,3,CX,0,89316,-89316
2016,3,CO,3935073,6669316,-2734243
2016,3,KM,0,445545,-445545
2016,3,CG,1300761,1871021,-570260
2016,3,CD,1880933,846130,1034803
2016,3,CK,0,10484,-10484
2016,3,CR,1336212,2824583,-1488371
2016,3,CI,30778323,8816820,21961503
2016,3,HR,746665,972102,-225437
2016,3,CU,445243,446146,-903
2016,3,CW,15503,113308,-97805
2016,3,CY,277754,751927,-474173
2016,3,CZ,15370731,26376779,-11006048
2016,3,KP,0,760122,-760122
2016,3,DK,13573598,13869537,-295939
2016,3,DJ,0,5602297,-5602297
2016,3,DM,0,74288,-74288
2016,3,DO,165816,2674748,-2508932
2016,3,EC,7633147,1285274,6347873
2016,3,EG,8030778,42395425,-34364647
2016,3,SV,61320,996721,-935401
2016,3,GQ,0,1112613,-1112613
2016,3,ER,0,455220,-455220
2016,3,EE,303529,3380909,-3077380
2016,3,ET,26578,11454152,-11427574
2016,3,FM,0,87262,-87262
2016,3,DE,476849806,467099187,9750619
2016,3,FJ,815,3994623,-3993808
2016,3,FI,17059494,9841919,7217575
2016,3,FR,139783625,128718037,11065588
2016,3,GF,0,142943,-142943
2016,3,PF,0,422400,-422400
2016,3,GA,866,1640607,-1639741
2016,3,GM,0,1594922,-1594922
2016,3,GE,85439,1223001,-1137562
2016,3,GH,19807291,24034152,-4226861
2016,3,GI,0,2895,-2895
2016,3,GR,696372,18890267,-18193895
2016,3,GL,17438,0,17438
2016,3,GD,0,420947,-420947
2016,3,GP,10177,163665,-153488
2016,3,GU,3555,182635,-179080
2016,3,GT,17894537,2102880,15791657
2016,3,GN,2363058,1018090,1344968
2016,3,GW,0,139780,-139780
2016,3,GY,21669,264486,-242817
2016,3,HT,0,912197,-912197
2016,3,HN,43271,948451,-905180
2016,3,HK,235438365,819291153,-583852788
2016,3,HU,13683205,18550578,-4867373
2016,3,IS,525447,38916,486531
2016,3,IN,297500290,704163755,-406663465
2016,3,IQ,261,8186784,-8186523
2016,3,IE,33009770,13198923,19810847
2016,3,IR,2760504,34168981,-31408477
2016,3,IT,109862007,86638634,23223373
2016,3,JM,66112,1910872,-1844760
2016,3,JP,1242012440,1506017464,-264005024
2016,3,JO,4640207,7908456,-3268249
2016,3,KZ,766146,3406175,-2640029
2016,3,KE,889752,11465029,-10575277
2016,3,KI,0,123713,-123713
2016,3,KW,34722237,19464535,15257702
2016,3,KG,8122,77027,-68905
2016,3,LV,1383401,1726323,-342922
2016,3,LB,976100,6427333,-5451233
2016,3,LS,0,138202,-138202
2016,3,LR,416401,1735662,-1319261
2016,3,LY,661523,17408906,-16747383
2016,3,LI,2741,74449,-71708
2016,3,LT,12463223,2083668,10379555
2016,3,LU,1786366,729546,1056820
2016,3,MO,898949,1870247,-971298
2016,3,MK,119125,34650,84475
2016,3,MG,2337801,6063092,-3725291
2016,3,MW,729312,2882975,-2153663
2016,3,MY,2924606,0,2924606
2016,3,MV,13343,9266305,-9252962
2016,3,ML,20,166405,-166385
2016,3,MT,3132827,1292465,1840362
2016,3,MH,0,167241,-167241
2016,3,MQ,0,166733,-166733
2016,3,MR,5583,1297618,-1292035
2016,3,MU,125200,7072838,-6947638
2016,3,YT,0,207107,-207107
2016,3,MX,35647413,142358759,-106711346
2016,3,ME,241863,87474,154389
2016,3,MA,2240983,6452406,-4211423
2016,3,MZ,1491645,11261111,-9769466
2016,3,NA,152975,479729,-326754
2016,3,NP,20396,2252877,-2232481
2016,3,NL,130671177,433522745,-302851568
2016,3,NC,27277,934470,-907193
2016,3,NZ,60090564,59958428,132136
2016,3,NI,51145,360909,-309764
2016,3,NE,0,402645,-402645
2016,3,NG,7530715,95366597,-87835882
2016,3,NF,0,5063,-5063
2016,3,MP,0,90295,-90295
2016,3,NO,19055581,10033175,9022406
2016,3,OM,13029625,25332517,-12302892
2016,3,ZZ,189190586,1478572,187712014
2016,3,PK,16187099,94948197,-78761098
2016,3,PW,0,121425,-121425
2016,3,PS,130018,158360,-28342
2016,3,PA,1488008,10248235,-8760227
2016,3,PG,10611071,42151242,-31540171
2016,3,PY,100408,1244879,-1144471
2016,3,LA,2121947,1580756,541191
2016,3,MN,6231,2016035,-2009804
2016,3,CN,2441598980,1915687861,525911119
2016,3,PE,2823125,6701321,-3878196
2016,3,PH,125089838,290021468,-164931630
2016,3,PL,19473731,23147876,-3674145
2016,3,PT,2493607,5918403,-3424796
2016,3,PR,1044597,718074,326523
2016,3,QA,7965489,10939957,-2974468
2016,3,ID,607535323,555908522,51626801
2016,3,KR,576658494,480534696,96123798
2016,3,MD,380,68657,-68277
2016,3,SG,1376944507,2287069501,-910124994
2016,3,ZA,44730701,62516160,-17785459
2016,3,LK,4296418,40325474,-36029056
2016,3,YE,1133011,7304847,-6171836
2016,3,RE,355,1489479,-1489124
2016,3,RO,2676008,9812644,-7136636
2016,3,RU,105697204,38985785,66711419
2016,3,RW,823469,136881,686588
2016,3,LC,0,13999,-13999
2016,3,ST,0,30307,-30307
2016,3,SA,210593575,72796972,137796603
2016,3,SN,402084,4087605,-3685521
2016,3,RS,221529,279468,-57939
2016,3,SC,0,917718,-917718
2016,3,SL,2217,979646,-977429
2016,3,SK,2244608,3900621,-1656013
2016,3,SI,2324346,7570438,-5246092
2016,3,VN,384394172,491691551,-107297379
2016,3,SB,167779,3364564,-3196785
2016,3,SO,0,6111711,-6111711
2016,3,ES,39130115,58983487,-19853372
2016,3,SD,128262,3109442,-2981180
2016,3,SR,39905,70619,-30714
2016,3,SW,546111,0,546111
2016,3,SZ,5069,20911,-15842
2016,3,SE,32954824,31758621,1196203
2016,3,CH,101603738,28072568,73531170
2016,3,SY,36318,2676394,-2640076
2016,3,TW,839629552,413866672,425762880
2016,3,TJ,0,162177,-162177
2016,3,TH,934691782,901327896,33363886
2016,3,TL,33547,673284,-639737
2016,3,TG,413444,4464984,-4051540
2016,3,TO,0,264551,-264551
2016,3,TT,66964,33883019,-33816055
2016,3,TN,2430943,4593815,-2162872
2016,3,TR,25263996,125892688,-100628692
2016,3,TM,205221,362349,-157128
2016,3,TV,0,34632,-34632
2016,3,UM,0,3443,-3443
2016,3,UG,805655,787958,17697
2016,3,UA,3561521,5228151,-1666630
2016,3,MM,24372322,104620990,-80248668
2016,3,AE,189268934,227811850,-38542916
2016,3,GB,161313295,186579242,-25265947
2016,3,TZ,336260,32447500,-32111240
2016,3,US,1184673550,1669147295,-484473745
2016,3,VI,0,353,-353
2016,3,UY,295781,2464333,-2168552
2016,3,UZ,410801,5915175,-5504374
2016,3,VU,256425,156840,99585
2016,3,VE,13780850,14778172,-997322
2016,3,WF,0,5571,-5571
2016,3,WS,0,587848,-587848
2016,3,ZM,608974,208444,400530
2016,3,ZW,695161,2203499,-1508338
2016,2,AF,703,5230578,-5229875
2016,2,AL,92656,146522,-53866
2016,2,DZ,823,15090751,-15089928
2016,2,AS,0,292110,-292110
2016,2,AD,0,27453,-27453
2016,2,AO,187787,5392352,-5204565
2016,2,AG,0,81446,-81446
2016,2,AR,72551503,13175540,59375963
2016,2,AM,0,400547,-400547
2016,2,AW,1461,127413,-125952
2016,2,AU,221971689,487647802,-265676113
2016,2,AT,38521734,10402927,28118807
2016,2,AZ,0,153927,-153927
2016,2,BS,82323,430908,-348585
2016,2,BH,7922840,5677795,2245045
2016,2,BD,14848734,65388194,-50539460
2016,2,BB,6005,117599,-111594
2016,2,BY,802838,130018,672820
2016,2,BE,40308104,65386303,-25078199
2016,2,BZ,7382,215946,-208564
2016,2,BJ,0,18504360,-18504360
2016,2,BM,0,3675,-3675
2016,2,BT,659,149115,-148456
2016,2,BO,1405086,727575,677511
2016,2,BA,0,40553,-40553
2016,2,BW,0,191573,-191573
2016,2,BR,151136652,53264710,97871942
2016,2,IO,0,773,-773
2016,2,VG,199037,12947,186090
2016,2,BN,13871286,33054281,-19182995
2016,2,BG,2053201,4464227,-2411026
2016,2,BF,1427453,73060,1354393
2016,2,KH,11865640,15001587,-3135947
2016,2,CM,6014938,1902952,4111986
2016,2,CA,62875884,48252058,14623826
2016,2,CV,0,28145,-28145
2016,2,KY,0,24508,-24508
2016,2,CF,0,210643,-210643
2016,2,TD,0,224527,-224527
2016,2,CL,3403942,10272138,-6868196
2016,2,CX,1548390,0,1548390
2016,2,CO,3869015,4696596,-827581
2016,2,KM,0,245977,-245977
2016,2,CG,1661247,2032821,-371574
2016,2,CD,4480972,775229,3705743
2016,2,CR,2371506,3082823,-711317
2016,2,CI,20645641,2548978,18096663
2016,2,HR,638941,1431445,-792504
2016,2,CU,171727,577360,-405633
2016,2,CW,38926,27016,11910
2016,2,CY,323545,345935,-22390
2016,2,CZ,12767254,23180996,-10413742
2016,2,KP,7211,114491,-107280
2016,2,DK,14235261,8768695,5466566
2016,2,DJ,0,8594274,-8594274
2016,2,DM,1662,4045,-2383
2016,2,DO,201658,2530656,-2328998
2016,2,EC,5913664,854772,5058892
2016,2,EG,9683169,45322392,-35639223
2016,2,SV,578,1638705,-1638127
2016,2,GQ,0,226632,-226632
2016,2,EE,283883,2640411,-2356528
2016,2,ET,947,11117185,-11116238
2016,2,FM,0,31845,-31845
2016,2,DE,442953315,426811157,16142158
2016,2,FJ,323515,4953951,-4630436
2016,2,FI,9284652,9119033,165619
2016,2,FR,246106968,108572049,137534919
2016,2,PF,0,268368,-268368
2016,2,GA,42754,1957756,-1915002
2016,2,GM,0,2046445,-2046445
2016,2,GE,1029349,950961,78388
2016,2,GH,10349825,6202239,4147586
2016,2,GI,0,3039,-3039
2016,2,GR,496574,30595052,-30098478
2016,2,GL,7584,0,7584
2016,2,GD,0,199232,-199232
2016,2,GP,0,365872,-365872
2016,2,GU,0,310501,-310501
2016,2,GT,29887,3070532,-3040645
2016,2,GN,0,817369,-817369
2016,2,GW,0,256176,-256176
2016,2,GY,70905,181875,-110970
2016,2,HT,2669,237239,-234570
2016,2,HM,353,0,353
2016,2,HN,273537,907315,-633778
2016,2,HK,184653768,638129595,-453475827
2016,2,HU,13612390,17936300,-4323910
2016,2,IS,158828,65983,92845
2016,2,IN,260408720,501027089,-240618369
2016,2,IQ,2536,5567043,-5564507
2016,2,IE,28028071,11155480,16872591
2016,2,IR,3070502,49096278,-46025776
2016,2,IT,81779935,66051402,15728533
2016,2,JM,144240,1340083,-1195843
2016,2,JP,1074579188,1335674406,-261095218
2016,2,JO,9725903,11238787,-1512884
2016,2,KZ,283128,2795577,-2512449
2016,2,KE,1006787,17586116,-16579329
2016,2,KI,0,27195,-27195
2016,2,KW,2936120,18962605,-16026485
2016,2,KG,21,137629,-137608
2016,2,LV,1539134,4318159,-2779025
2016,2,LB,212594,4627776,-4415182
2016,2,LS,0,5745,-5745
2016,2,LR,824757,1708400,-883643
2016,2,LY,1796470,1493795,302675
2016,2,LI,4107,19557,-15450
2016,2,LT,4929690,2736955,2192735
2016,2,LU,970555,533214,437341
2016,2,MO,1220271,1723814,-503543
2016,2,MK,88414,53805,34609
2016,2,MG,885001,6969132,-6084131
2016,2,MW,213767,3200637,-2986870
2016,2,MY,1354696,0,1354696
2016,2,MV,1102,8489097,-8487995
2016,2,ML,2275,35957,-33682
2016,2,MT,3744853,1941349,1803504
2016,2,MH,0,45995,-45995
2016,2,MQ,0,51935,-51935
2016,2,MR,37389,1894529,-1857140
2016,2,MU,439733,4547206,-4107473
2016,2,YT,0,121285,-121285
2016,2,MX,22631167,126970701,-104339534
2016,2,ME,0,68263,-68263
2016,2,MA,1900243,6098926,-4198683
2016,2,MZ,22424,5009793,-4987369
2016,2,NA,260329,1053876,-793547
2016,2,NR,0,1806,-1806
2016,2,NP,62247,4194402,-4132155
2016,2,NL,123519111,398951919,-275432808
2016,2,NC,321,849010,-848689
2016,2,NZ,56937155,52753961,4183194
2016,2,NI,99421,1229833,-1130412
2016,2,NE,0,266585,-266585
2016,2,NG,2288101,38312008,-36023907
2016,2,NF,0,21544,-21544
2016,2,MP,0,143363,-143363
2016,2,NO,14192486,6954833,7237653
2016,2,OM,47430391,14467244,32963147
2016,2,ZZ,131205585,1495332,129710253
2016,2,PK,12821679,50692288,-37870609
2016,2,PW,0,10685,-10685
2016,2,PS,108613,226050,-117437
2016,2,PA,533418,7655495,-7122077
2016,2,PG,5592329,21261410,-15669081
2016,2,PY,5427939,467070,4960869
2016,2,LA,12730,1178287,-1165557
2016,2,MN,5545,807689,-802144
2016,2,CN,2118345537,1549478126,568867411
2016,2,PE,6005317,6597977,-592660
2016,2,PH,116939105,261576787,-144637682
2016,2,PL,15669228,21351048,-5681820
2016,2,PT,2067668,4659914,-2592246
2016,2,PR,233484,719637,-486153
2016,2,QA,7128072,9381437,-2253365
2016,2,ID,537382053,485769634,51612419
2016,2,KR,528983293,530868537,-1885244
2016,2,MD,159095,64233,94862
2016,2,SG,1273649128,1897714235,-624065107
2016,2,ZA,28471164,46407447,-17936283
2016,2,LK,3399059,34759250,-31360191
2016,2,YE,69468,11177983,-11108515
2016,2,RE,45159,824078,-778919
2016,2,RO,2396687,6799932,-4403245
2016,2,RU,65174278,44426275,20748003
2016,2,RW,1928577,109319,1819258
2016,2,KN,0,2442,-2442
2016,2,LC,0,15608,-15608
2016,2,VC,0,101257,-101257
2016,2,SA,133967507,67807142,66160365
2016,2,SN,12071,4045317,-4033246
2016,2,RS,65155,295020,-229865
2016,2,SC,3374,625937,-622563
2016,2,SL,0,719030,-719030
2016,2,SK,3250748,4058583,-807835
2016,2,SI,1655614,8607259,-6951645
2016,2,VN,279132622,303033035,-23900413
2016,2,SB,482138,1261992,-779854
2016,2,SO,0,4207249,-4207249
2016,2,SS,0,4210,-4210
2016,2,ES,41062257,26062285,14999972
2016,2,SD,100952,2886316,-2785364
2016,2,SR,68824,94280,-25456
2016,2,SW,243006,0,243006
2016,2,SZ,61468,42826,18642
2016,2,SE,33302216,27716258,5585958
2016,2,CH,98409035,30578987,67830048
2016,2,SY,0,3844588,-3844588
2016,2,TW,586938086,314826289,272111797
2016,2,TJ,0,72704,-72704
2016,2,TH,763808990,783772073,-19963083
2016,2,TL,21953,979822,-957869
2016,2,TG,2038,3173991,-3171953
2016,2,TO,0,268063,-268063
2016,2,TT,25030204,1599544,23430660
2016,2,TN,524538,5166837,-4642299
2016,2,TR,18261205,109026662,-90765457
2016,2,TM,14432,770441,-756009
2016,2,TV,0,50576,-50576
2016,2,UM,0,442,-442
2016,2,UG,218200,521917,-303717
2016,2,UA,11847350,7176437,4670913
2016,2,MM,13080764,63352073,-50271309
2016,2,AE,248923629,221913561,27010068
2016,2,GB,121205021,147632206,-26427185
2016,2,TZ,8189190,18244233,-10055043
2016,2,US,1130800563,1416515078,-285714515
2016,2,VI,0,1797,-1797
2016,2,UY,2433840,1589496,844344
2016,2,UZ,383970,10247558,-9863588
2016,2,VU,290653,157307,133346
2016,2,VE,12997909,134624,12863285
2016,2,WF,0,10737,-10737
2016,2,WS,0,301809,-301809
2016,2,ZM,3070580,139559,2931021
2016,2,ZW,398221,124703,273518
2016,1,AF,10609,6533359,-6522750
2016,1,AL,7947,95077,-87130
2016,1,DZ,0,11758400,-11758400
2016,1,AS,0,39681,-39681
2016,1,AD,0,72293,-72293
2016,1,AO,290967,8731875,-8440908
2016,1,AI,0,4578,-4578
2016,1,AG,0,399412,-399412
2016,1,AR,43458878,12524335,30934543
2016,1,AM,0,195464,-195464
2016,1,AW,0,26220,-26220
2016,1,AU,289092801,500157200,-211064399
2016,1,AT,44902463,9958516,34943947
2016,1,AZ,0,1812406,-1812406
2016,1,BS,8385,254562,-246177
2016,1,BH,3124641,4144108,-1019467
2016,1,BD,13382659,79600614,-66217955
2016,1,BB,2797,107154,-104357
2016,1,BY,2073899,1660,2072239
2016,1,BE,45226976,76072539,-30845563
2016,1,BZ,0,146955,-146955
2016,1,BJ,6917,13730284,-13723367
2016,1,BM,0,1756,-1756
2016,1,BT,0,263306,-263306
2016,1,BO,1190716,57556,1133160
2016,1,BA,277,2793,-2516
2016,1,BW,2178,536091,-533913
2016,1,BR,223793600,60837338,162956262
2016,1,VG,95994,25355,70639
2016,1,BN,2199608,42249151,-40049543
2016,1,BG,2677447,5559749,-2882302
2016,1,BF,564436,359,564077
2016,1,KH,10726313,43943322,-33217009
2016,1,CM,6089489,795461,5294028
2016,1,CA,52299519,54307996,-2008477
2016,1,KY,0,217052,-217052
2016,1,CF,0,603336,-603336
2016,1,CL,15110320,22092794,-6982474
2016,1,CX,1732995,7274,1725721
2016,1,CO,2162527,3604871,-1442344
2016,1,KM,0,232044,-232044
2016,1,CG,587152,1043978,-456826
2016,1,CD,5570582,944780,4625802
2016,1,CR,1380927,3945432,-2564505
2016,1,CI,35987327,2596585,33390742
2016,1,HR,353378,921755,-568377
2016,1,CU,337704,677297,-339593
2016,1,CW,21829,11864,9965
2016,1,CY,740551,652675,87876
2016,1,CZ,13044343,24920668,-11876325
2016,1,KP,9429,35402,-25973
2016,1,DK,15589547,10944830,4644717
2016,1,DJ,0,5918512,-5918512
2016,1,DM,0,43056,-43056
2016,1,DO,50259,2567043,-2516784
2016,1,EC,11953247,909753,11043494
2016,1,EG,8369882,35548905,-27179023
2016,1,SV,8269,1027776,-1019507
2016,1,GQ,4219,1228790,-1224571
2016,1,ER,0,49943,-49943
2016,1,EE,337257,3142701,-2805444
2016,1,ET,2893,4183255,-4180362
2016,1,FM,0,2278,-2278
2016,1,DE,448030610,394615831,53414779
2016,1,FJ,0,4382947,-4382947
2016,1,FI,11651872,9171434,2480438
2016,1,FR,114726933,115086325,-359392
2016,1,PF,0,292058,-292058
2016,1,GA,22038970,2792677,19246293
2016,1,GM,0,2112476,-2112476
2016,1,GE,263578,673430,-409852
2016,1,GH,9898106,4915695,4982411
2016,1,GI,0,1751,-1751
2016,1,GR,1873576,24266679,-22393103
2016,1,GD,0,322733,-322733
2016,1,GP,0,146588,-146588
2016,1,GU,2335,170789,-168454
2016,1,GT,78288,3098141,-3019853
2016,1,GN,0,3080986,-3080986
2016,1,GW,0,106811,-106811
2016,1,GY,49079,659319,-610240
2016,1,HT,3783,347868,-344085
2016,1,HN,42286,1423055,-1380769
2016,1,HK,231447499,665353397,-433905898
2016,1,HU,10387702,17677135,-7289433
2016,1,IS,47479,57576,-10097
2016,1,IN,365339064,589414481,-224075417
2016,1,IQ,78952,6090663,-6011711
2016,1,IE,30982670,12416478,18566192
2016,1,IR,3526103,39871698,-36345595
2016,1,IT,99841574,84152518,15689056
2016,1,JM,208038,1277040,-1069002
2016,1,JP,954049973,1268015456,-313965483
2016,1,JO,2869177,12097248,-9228071
2016,1,KZ,224169,2126991,-1902822
2016,1,KE,636090,14378842,-13742752
2016,1,KI,0,34810,-34810
2016,1,KW,83812476,15088850,68723626
2016,1,KG,0,53408,-53408
2016,1,LV,1131111,6357191,-5226080
2016,1,LB,871816,4842918,-3971102
2016,1,LS,6625,0,6625
2016,1,LR,2477875,4404349,-1926474
2016,1,LY,75190,1465354,-1390164
2016,1,LI,2231,17262,-15031
2016,1,LT,4857146,3827089,1030057
2016,1,LU,502218,765887,-263669
2016,1,MO,1361974,3205506,-1843532
2016,1,MK,111706,9675,102031
2016,1,MG,1391509,4561779,-3170270
2016,1,MW,823717,177527,646190
2016,1,MY,2440089,0,2440089
2016,1,MV,1727,7684517,-7682790
2016,1,ML,0,223570,-223570
2016,1,MT,4212836,2131585,2081251
2016,1,MH,4236933,28592,4208341
2016,1,MQ,0,127940,-127940
2016,1,MR,7073,5716525,-5709452
2016,1,MU,131600,5946105,-5814505
2016,1,YT,0,6049673,-6049673
2016,1,MX,28193506,144042129,-115848623
2016,1,MC,0,408,-408
2016,1,ME,0,37624,-37624
2016,1,MA,2008019,3439764,-1431745
2016,1,MZ,319540,4276260,-3956720
2016,1,NA,277445,92303,185142
2016,1,NR,0,57858,-57858
2016,1,NP,61529,2925452,-2863923
2016,1,NL,112575541,415476121,-302900580
2016,1,NC,95812,5607688,-5511876
2016,1,NZ,52631598,48579560,4052038
2016,1,NI,52490,1317501,-1265011
2016,1,NE,0,709037,-709037
2016,1,NG,3847997,77100432,-73252435
2016,1,MP,0,98130,-98130
2016,1,NO,22173978,9620659,12553319
2016,1,OM,14136426,15199557,-1063131
2016,1,ZZ,147795230,664183,147131047
2016,1,PK,12418980,89786587,-77367607
2016,1,PW,0,7512,-7512
2016,1,PS,7245,233652,-226407
2016,1,PA,1101346,4542558,-3441212
2016,1,PG,9696400,25901376,-16204976
2016,1,PY,3557308,4926219,-1368911
2016,1,LA,1894326,2310336,-416010
2016,1,MN,45592,595256,-549664
2016,1,CN,2688539729,1499089238,1189450491
2016,1,PE,3438824,5382895,-1944071
2016,1,PH,114068762,262704323,-148635561
2016,1,PL,17452302,27119223,-9666921
2016,1,PT,2100198,5555171,-3454973
2016,1,PR,78432,571834,-493402
2016,1,QA,29089469,12347809,16741660
2016,1,ID,541828372,527222782,14605590
2016,1,KR,654912737,464335736,190577001
2016,1,MD,588345,55174,533171
2016,1,SG,1507449808,2070221203,-562771395
2016,1,ZA,35692941,43058838,-7365897
2016,1,LK,6074586,44404529,-38329943
2016,1,YE,330940,10164254,-9833314
2016,1,RE,101135,773902,-672767
2016,1,RO,2434789,8354880,-5920091
2016,1,RU,44185398,34679679,9505719
2016,1,RW,686107,35401,650706
2016,1,LC,0,37180,-37180
2016,1,VC,0,106481,-106481
2016,1,SM,307,0,307
2016,1,ST,0,37230,-37230
2016,1,SA,149374429,51714307,97660122
2016,1,SN,385,3543937,-3543552
2016,1,RS,204847,528877,-324030
2016,1,SC,0,9479581,-9479581
2016,1,SL,0,880772,-880772
2016,1,SK,1694604,4974652,-3280048
2016,1,SI,1151991,7890480,-6738489
2016,1,VN,347105625,295716907,51388718
2016,1,SB,845246,2779894,-1934648
2016,1,SO,0,7266432,-7266432
2016,1,ES,30508537,46725288,-16216751
2016,1,SD,86336,2584455,-2498119
2016,1,SR,84695,386373,-301678
2016,1,SW,138670,0,138670
2016,1,SZ,1534,34346,-32812
2016,1,SE,31643368,24454411,7188957
2016,1,CH,187089460,36843107,150246353
2016,1,SY,81636,2439917,-2358281
2016,1,TW,697574384,338629569,358944815
2016,1,TJ,0,30783,-30783
2016,1,TH,787880525,930516142,-142635617
2016,1,TL,13109,6519895,-6506786
2016,1,TG,342835,2218991,-1876156
2016,1,TO,0,127436,-127436
2016,1,TT,8208,3124720,-3116512
2016,1,TN,596667,4017628,-3420961
2016,1,TR,22313401,133728042,-111414641
2016,1,TM,1250,945840,-944590
2016,1,TV,0,12583,-12583
2016,1,UM,0,77540,-77540
2016,1,UG,171349,1790227,-1618878
2016,1,UA,3927602,14577636,-10650034
2016,1,MM,14546845,52459133,-37912288
2016,1,AE,171292582,291224305,-119931723
2016,1,GB,137473715,166828578,-29354863
2016,1,TZ,18385639,21339638,-2953999
2016,1,US,1027583998,1456820553,-429236555
2016,1,UY,3609039,1797813,1811226
2016,1,UZ,3991,8218267,-8214276
2016,1,VU,343645,110116,233529
2016,1,VE,14069764,460206,13609558
2016,1,WS,0,434516,-434516
2016,1,ZM,7814,190309,-182495
2016,1,ZW,439766,202226,237540
